甘草		补脾益气 、 清热解毒 、 祛痰止咳 、 缓急 止痛 、 调和 诸 药 ， 脾胃虚弱 ， 倦怠 乏力 ， 心悸 气 短 ， 咳嗽痰多 ， 脘 腹 、 四肢 挛急 疼痛 ， 痈肿 疮 毒 ， 缓解 药物 毒性 、 烈性
当归		补血 活血 、 调经止痛 、 润肠通便 ， 血虚 萎黄 、 眩晕 心悸 、 月经不调 、 经闭 痛经 、 虚寒 腹痛 、 肠燥便秘 、 风湿痹 痛 、 跌 扑 损伤 、 痈疽 疮疡
茯苓		利水渗湿 、 健脾 宁 心 ， 水肿 尿 少 、 痰饮眩晕 、 脾虚 食少 、 便 溏 泄泻 、 心神不安 、 惊悸 失眠
人参		大 补 元气 、 复 脉 固 脱 、 补脾益肺 、 生津 、 安神 ， 体 虚 欲 脱 、 肢 冷脉微 、 脾虚 食少 、 肺虚 喘咳 、 津 伤 口渴 、 内热 消渴 、 久 病 虚 羸 、 惊悸 失眠 、 阳痿 宫 冷 、 心力衰竭 、 心源性休克 等
白术		健脾益气 、 燥湿 利水 、 止汗 、 安胎 ， 脾虚 食少 、 腹痛 泄泻 、 痰饮眩晕 、 水肿 、 自汗 、 胎动不安
黄芩		清热燥湿 、 泻火解毒 、 止血 、 安胎 ， 湿温 、 暑温 胸闷 呕 恶 、 湿热 痞满 、 泻痢 、 黄疸 、 肺热咳嗽 、 高热 烦渴 、 血热 吐 衄 、 痈肿 疮 毒 、 胎动不安
防风		解表 祛风 、 胜 湿 、 止 痉 ， 感冒头痛 、 风湿痹 痛 、 风疹 瘙 痒 、 破伤风
川芎		活血行气 、 祛风止痛 ， 经闭 痛经 、 癥瘕 腹痛 、 胸胁 刺 痛 、 跌 扑 肿 痛 、 头痛 、 风湿痹 痛
木香		行气止痛 、 健脾消食 ， 胸 脘 胀 痛 、 泻痢 后重 、 食积 不消 、 不思饮食
黄连		清热燥湿 、 泻火解毒 ， 湿热 痞满 、 呕吐 吞酸 、 泻痢 、 黄疸 、 高热 神昏 、 心火亢盛 、 心烦 不寐 、 血热 吐 衄 、 目赤 、 牙痛 、 消渴 、 痈肿 疔疮 ， 外治 湿疹 、 湿 疮 、 耳 道 流 脓
大黄		泻热 通 肠 、 凉血解毒 、 逐瘀 通经 ， 实热 便秘 、 积滞 腹痛 、 泻痢 不 爽 、 湿热 黄疸 、 血热 吐 衄 、 目赤 、 咽肿 、 肠痈腹痛 、 痈肿 疔疮 、 瘀血 经闭 、 跌 扑 损伤 ， 外治 水火烫伤 、 上消化道出血
半夏		燥湿化痰 、 降逆止呕 、 消痞散结 ， 痰 多 咳喘 、 痰饮 眩 悸 、 风痰眩晕 、 痰厥头痛 、 呕吐 反胃 、 胸脘痞闷 、 梅核气 ， 生 用 外治 痈肿 痰核
陈皮		理气健脾 、 燥湿化痰 ， 胸 脘 胀 满 、 食少 吐泻 、 咳嗽痰多
白芍		平肝 止痛 、 养血调经 、 敛阴止汗 ， 头痛 目眩 、 胁痛 、 腹痛 、 四肢 挛痛 、 血虚 萎黄 、 月经不调 、 自汗 、 盗汗
麝香		开窍 醒 神 、 活血通经 、 消肿止痛 ， 热病神昏 、 中风痰厥 、 气 郁暴厥 、 中恶 昏迷 、 经闭 、 癥瘕 、 难产 死胎 、 心腹 暴 痛 、 痈肿 瘰疬 、 咽喉肿痛 、 跌 扑 伤痛 、 痹 痛 麻木 等
枳壳		理气 宽中 、 行滞 消胀 ， 胸胁 气滞 、 胀 满 疼痛 、 食积 不 化 、 痰饮 内 停 、 胃下垂 、 脱肛 、 子宫脱垂
干姜		温中散寒 、 回阳通脉 、 燥湿 消痰 ， 脘 腹冷痛 、 呕吐泄泻 、 肢 冷脉微 、 痰饮喘咳
附子		回阳救逆 、 补火 助阳 、 逐 风寒 湿邪 ， 亡阳 虚脱 、 肢 冷脉微 、 阳痿 、 宫 冷 、 心腹 冷 痛 、 虚寒 吐泻 、 阴寒 水肿 、 阳虚外感 、 寒湿 痹 痛
桔梗		宣肺 、 利咽 、 祛痰 、 排 脓 ， 咳嗽痰多 、 胸闷 不 畅 、 咽痛 、 音 哑 、 肺痈 吐 脓 、 疮疡 脓 成 不 溃
柴胡		和解表里 、 疏肝 、 升阳 ， 感冒 发热 、 寒热往来 、 胸胁 胀 痛 、 月经不调 、 子宫脱垂 、 脱肛
白芷		散风 除湿 、 通窍 止痛 、 消肿 排 脓 ， 感冒头痛 、 眉棱骨痛 、 鼻渊 、 牙痛 、 白带 、 疮疡 肿 痛
生姜		解表散寒 、 温 中止 呕 、 化痰止咳 ， 风寒感冒 ， 胃寒呕吐 ， 寒痰 咳嗽
赤芍		清热凉血 、 散瘀 止痛 ， 临床 温毒发斑 、 吐血 衄血 、 目赤 肿 痛 、 肝郁胁痛 、 经闭 痛经 、 癥瘕 腹痛 、 跌 扑 损伤 、 痈肿 疮疡
厚朴		燥湿 消痞 、 下气 除 满 ， 湿 滞 伤中 、 脘痞 吐泻 、 食积 气滞 、 腹胀 便秘 、 痰饮喘咳
乳香		调气 活血 、 止痛 、 追 毒 ， 气血 凝滞 、 心腹 疼痛 、 痈疮 肿毒 等
槟榔		杀 虫 消积 、 降气 、 行水 、 截疟 ， 绦虫 、 蛔虫 、 姜片虫病 、 虫积腹痛 、 积滞 泻痢 、 里急后重 、 水肿 脚气 、 疟疾
羌活		散 寒 、 祛风 、 止痛 ， 风寒 感冒头痛 、 风湿痹 痛 、 肩 背 酸痛
细辛		祛风散 寒 、 通窍 止痛 、 温肺化饮 ， 风寒感冒 、 头痛 、 牙痛 、 鼻塞 鼻渊 、 风湿痹 痛 、 痰饮喘咳
黄柏		清热燥湿 、 泻火 除 蒸 、 解毒 疗 疮 ， 湿热 泻痢 、 黄疸 、 带下 、 热淋 、 脚气 、 痿躄 、 骨蒸 劳热 、 盗汗 、 遗精 、 疮疡 肿毒 、 湿疹 瘙 痒
升麻		发表 透疹 、 清热解毒 、 升 举 阳气 ， 风热头痛 、 齿痛 、 口疮 、 咽喉肿痛 、 麻疹 不 透 、 阳 毒 发 斑 、 脱肛 、 子宫脱垂
朱砂		清心 镇 惊 、 安神 解毒 ， 心悸 易 惊 、 失眠多梦 、 癫痫 发狂 、 小儿惊风 、 视 物 昏花 、 口疮 、 喉痹 、 疮疡 肿毒
荆芥		解表 散风 、 透疹 ， 感冒 、 头痛 、 麻疹 、 风疹 、 疮疡 初 起 收涩止血 ， 治疗 便血 、 崩漏 、 产后血晕 解表 散风 、 透疹 ， 治疗 感冒 、 头痛 、 麻疹 、 风疹 、 疮疡 初 起 收涩止血 ， 治疗 便血 、 崩漏 、 产后血晕
香附		行气解郁 、 调经止痛 ， 肝郁气滞 ， 胸 、 胁 、 脘 腹胀 痛 ， 消化不良 ， 胸脘痞闷 ， 寒疝 腹痛 ， 乳房 胀 痛 ， 月经不调 ， 经闭 痛经
雄黄		解 毒杀 虫 、 燥湿 祛痰 、 截疟 ， 痈肿 疔疮 、 蛇 虫 咬 伤 、 虫积腹痛 、 惊痫 、 疟疾
苍术		燥湿 健脾 、 祛风散 寒 、 明目 ， 脘腹胀满 、 泄泻 、 水肿 、 脚气 痿躄 、 风湿痹 痛 、 风寒感冒 、 夜盲
石膏		清热泻火 、 除 烦 止渴 ， 外感 热病 、 高热 烦渴 、 肺 热 喘咳 、 胃火 亢 盛 、 头痛 、 牙痛
牛膝		补肝肾 、 强 筋骨 、 逐瘀 通经 、 引 血 下 行 ， 腰膝酸痛 、 筋骨 无力 、 经闭 癥瘕 、 肝阳眩晕
麻黄		发汗散 寒 、 宣肺平喘 、 利水 消肿 ， 风寒感冒 、 胸闷 喘咳 、 风水 浮肿 、 支气管哮喘
没药		散 血 去 瘀 、 消肿 定 痛 ， 跌打损伤 、 金疮 、 癥瘕 等
丁香		温中 降逆 、 补肾助阳 ， 脾胃虚寒 、 呃逆 呕吐 、 食少 吐泻 、 心腹 冷 痛 、 肾虚 阳痿 等
薄荷		宣散风 热 、 清 头目 、 透疹 ， 风热感冒 、 风温 初 起 、 头痛 、 目赤 、 喉痹 、 口疮 、 风疹 、 麻疹 、 胸胁 胀 闷
栀子		泻火 除 烦 、 清热 利尿 、 凉血解毒 ， 热病 心烦 、 黄疸 尿 赤 、 血淋 涩 痛 、 血热 吐 衄 、 目赤 肿 痛 、 火毒 疮疡 ， 外治 扭 挫伤 痛 凉血止血 ， 血热 吐 衄 、 尿 血崩 漏
芍药		清热凉血
五味子		收敛 固涩 、 益气生津 、 补肾 宁 心 ， 久嗽 虚喘 、 梦遗 滑精 、 遗尿 尿频 、 久泻 不 止 、 自汗 、 盗汗 、 津 伤 口渴 、 短气 脉 虚 、 内热 消渴 、 心悸失眠
知母		清热泻火 、 生津润燥 ， 外感 热病 、 高热 烦渴 、 肺 热 燥 咳 、 骨蒸潮热 、 内热 消渴 、 肠燥便秘
连翘		清热解毒 、 消肿散结 ， 痈疽 、 瘰疬 、 乳痈 、 丹毒 、 风热感冒 、 湿病 初 起 、 温热 入 营 、 高热 烦渴 、 神昏 发 斑 、 热淋 尿闭
木通		清心 火 、 利小便 、 通经 下乳 ， 胸中烦热 、 喉痹 咽痛 、 尿 赤 、 五淋 、 水肿 、 周身 挛痛 、 经闭 乳少
青皮		疏肝 破气 、 消积 化 滞 ， 胸胁 胀 痛 、 疝气 、 乳核 、 乳痈 、 食积腹痛
泽泻		利小便 、 清 湿热 ， 小便不利 、 水 肿胀 满 、 泄泻 尿 少 、 痰饮眩晕 、 热淋 涩 痛 、 高 血脂
山药		补脾 养胃 、 生津益 肺 、 补肾 涩 精 ， 脾虚 食少 、 久泻 不 止 、 肺虚 喘咳 、 肾虚 遗精 、 带下 、 尿频 、 虚热 消渴
巴豆		药材 为 双子叶 植物药 大戟 科巴 豆 属 植物 巴豆 的 干燥 成熟 果实 ， 外用 蚀疮 ， 恶疮 疥癣 、 疣 痣 。 外用 适量 ， 研 末 涂 患 处 ， 或 捣 烂 以 纱布 包 擦 患处 。
砂仁		化湿 开胃 、 温脾 止泻 、 理气安胎 ， 湿浊 中 阻 、 脘痞 不 饥 、 脾胃虚寒 、 呕吐泄泻 、 妊娠恶阻 、 胎动不安
麦冬		养阴生津 、 润肺 清心 ， 肺 燥 干咳 、 虚痨 咳嗽 、 津 伤 口渴 、 心烦 失眠 、 内热 消渴 、 肠燥便秘 、 咽白喉
肉桂		补火 助阳 、 引 火 归 源 、 散寒止痛 、 活血通经 ， 阳痿 、 宫 冷 、 腰 膝 冷 痛 、 肾虚 作 喘 、 阳虚眩晕 、 目赤 咽痛 、 心腹 冷 痛 、 虚寒 吐泻 、 寒疝 、 奔豚 、 经闭 、 痛经
僵蚕		祛风 定 痉 、 化痰散结 ， 惊风 抽搐 、 咽喉肿痛 、 皮肤瘙痒 、 颌下淋巴结炎 、 面神经麻痹
生地黄		清热凉血 、 养阴 、 生津 ， 热病 舌绛 烦渴 、 阴虚内热 、 骨蒸 劳热 、 内热 消渴 、 吐血 、 衄血 、 发 斑 发 疹
远志		安神 益智 、 祛痰 、 消肿 ， 心肾不交 引起 的 失眠多梦 、 健忘 惊悸 、 神志 恍惚 、 咳 痰 不 爽 、 疮疡 肿毒 、 乳房 肿 痛
桃仁		活血祛瘀 、 润肠通便 ， 经闭 、 痛经 、 癥瘕 痞块 、 跌 扑 损伤
玄参		凉血 滋阴 、 泻火解毒 ， 热病 伤阴 、 舌绛 烦渴 、 温毒发斑 、 津 伤 便秘 、 骨蒸 劳嗽 、 目赤 、 咽痛 、 瘰疬 、 白喉 、 痈肿 疮 毒
独活		祛风除湿 、 通痹 止痛 ， 风寒湿痹 、 腰膝酸痛 、 少 阴伏风 头痛
犀角		清热 、 凉血 、 定 惊 、 解毒 ， 伤寒 温疫 热入血分 、 惊狂 等
沉香		行气止痛 、 温 中止 呕 、 纳气平喘 ， 胸 腹胀 闷 疼痛 、 胃寒呕吐 呃逆 、 肾虚 气逆 喘急
天麻		平肝熄风 止 痉 ， 头痛 眩晕 、 肢体麻木 、 小儿惊风 、 癫痫 抽搐 、 破伤风
龙骨		镇惊安神 、 敛汗 固精 、 止血 涩 肠 、 生 肌 敛 疮
冰片		开窍 醒 神 、 清热止痛 ， 临床 热病神昏 、 惊厥 、 中风痰厥 、 气 郁暴厥 、 中恶 昏迷 、 目赤 、 口疮 、 咽喉肿痛 、 耳 道 流 脓
白矾		为 硫酸盐 类 矿物 明矾石 经 加工 提炼 制成 ， 主 含 含 水 硫酸 铝 钾 。 外用 解 毒杀 虫 、 燥湿 止痒 ， 内服 止血 止泻 、 祛 除 风痰 ， 外治 湿疹 、 疥癣 、 聤耳 流 脓 ， 内服 久泻 不 止 、 便血 、 崩漏 、 癫痫 发狂 。 枯矾 收 湿 敛 疮 、 止血 化 腐 ， 湿疹 湿 疮 、 聤耳 流 脓 、 阴痒 带下 、 鼻衄 齿衄 、 鼻 瘜肉 。
红花		活血通经 、 散瘀 止痛 ， 经闭 、 痛经 、 恶露 不行 、 癥瘕 痞块 、 疮疡 肿 痛
枳实		破气 消积 、 化痰 散 痞 ， 积滞 内 停 、 痞满 胀 痛 、 泻痢 后重 、 大便不通 、 痰 滞气 阻 胸痹 、 结胸 、 胃下垂 、 脱肛 、 子宫脱垂
滑石		利尿 通淋 、 清热解毒 、 祛湿 敛 疮 ， 热淋 、 石淋 、 尿 热 涩 痛 、 暑热 烦渴 、 湿 热水 泻 ， 外治 湿疹 、 湿 疮 、 痱子
牛黄		清心 、 豁痰 、 开窍 、 凉肝 、 熄风 、 解毒 ， 热病神昏 、 中风 痰迷 、 惊痫 抽搐 、 癫痫 发狂 、 咽喉肿痛 、 口舌生疮 、 痈肿 疔疮
阿胶		补血 滋阴 、 润燥 、 止血 ， 血虚 萎黄 、 眩晕 心悸 、 肌痿 无力 、 心烦 不 眠 、 虚风内动 、 肺燥咳嗽 、 劳嗽 咯血 、 吐血 尿血 、 便 血崩 漏 、 妊娠 胎漏
轻粉		为 氯化亚汞 ， 外用 杀 虫 、 攻 毒 、 敛 疮 ， 内服 祛痰 消积 、 逐水 通便 ， 外治 疥疮 、 顽癣 、 臁疮 、 梅毒 、 疮疡 、 湿疹 ， 内服 痰 涎 积滞 、 水肿 臌胀 、 二 便 不利 。
吴茱萸		散寒止痛 、 降逆止呕 、 助阳 止泻 ， 厥阴头痛 、 寒疝 腹痛 、 寒湿脚气 、 经行腹痛 、 脘 腹胀 痛 、 呕吐 吞酸 、 五更泄泻 ， 外治 口疮 、 高血压
前胡		散风 清热 、 降气化痰 ， 风热 咳嗽痰多 、 痰 热 喘满 、 咯痰 黄稠
神曲		健脾和胃 、 消食 调 中 ， 饮食 停滞 、 胸痞 腹胀 等
川乌		祛风除湿 、 温经止痛 、 麻醉 止痛 ， 风寒湿痹 、 关节疼痛 、 心腹 冷 痛 、 寒疝 作 痛 、 麻醉 止痛
杜仲		补肝肾 、 强 筋骨 、 安胎 ， 肾虚腰痛 、 筋骨 无力 、 妊娠 漏 血 、 胎动不安 、 高血压
地骨皮		凉血 除 蒸 、 清肺 降火 ， 阴虚潮 热 、 骨蒸 盗汗 、 肺 热 咳喘 、 咯血 、 衄血 、 内热 消渴
全蝎		熄风 镇 痉 、 攻 毒 散结 、 通络止痛 ， 小儿惊风 、 抽搐 痉挛 、 中 风口 ? 、 半身不遂 、 破伤风 、 风湿 顽痹 、 偏正头痛 、 疮疡 、 瘰疬
车前子		清热 利尿 、 渗湿 通淋 、 明目 、 祛痰 ， 水 肿胀 满 、 热淋 涩 痛 、 暑湿 泄泻 、 目赤 肿 痛 、 痰 热 咳嗽
熟地黄		滋阴补血 、 益 髓 填 精 ， 肝肾阴虚 、 腰膝酸软 、 骨蒸潮热 、 盗汗 遗精 、 内热 消渴 、 血虚 萎黄 、 心悸怔忡 、 月经不调 、 崩漏 下血 、 眩晕 、 耳鸣 、 须发 早 白
菟丝子		滋补肝肾 、 固精 缩 尿 、 安胎 、 明目 、 止泻 ， 阳痿 遗精 、 尿 有余 沥 、 遗尿 尿频 、 腰膝酸软 、 目昏 耳鸣 、 肾虚 胎漏 、 胎动不安 、 脾 肾 虚泻 ， 外治 白癜风
葛根		解肌退热 、 生津 、 透疹 、 升阳 止泻 ， 外感 发热 头痛 、 项背强 痛 、 口渴 、 消渴 、 麻疹 不 透 、 热痢 、 泄泻 、 高血压 颈项强痛
青黛		清热解毒 、 凉血 、 定 惊 ， 温毒发斑 、 血热 吐 衄 、 胸痛 咳血 、 口疮 、 痄腮 、 喉痹 、 小儿 惊痫 ， 宜 入 丸 散 ， 外用 适量
山楂		消食健胃 、 行气 散瘀 ， 肉 食积 滞 、 胃脘 胀 满 、 泻痢 腹痛 、 瘀血 经闭 、 产 后 瘀 阻 、 心腹 刺 痛 、 疝气 疼痛 、 高脂血症
乌梅		敛肺 、 涩 肠 、 生津 、 安 蛔 ， 肺虚 久咳 、 久痢 滑 肠 、 虚热 消渴 ， 蛔厥 呕吐 腹痛 、 胆道蛔虫 症
三棱		破血 行气 、 消积 止痛 ， 癥瘕 痞块 、 瘀血 经闭 、 食积 胀 痛
菊花		散风 清热 、 平肝 明目 ， 风热感冒 、 头痛 眩晕 、 目赤 肿 痛 、 眼目 昏花
丹参		祛瘀 止痛 、 活血通经 、 安神宁 心 、 排 脓 、 止痛 ， 心绞痛 等
牡蛎		重镇安神 、 潜阳 补阴 、 软坚散结 ， 惊悸 失眠 、 眩晕耳鸣 、 瘰疬 痰核 、 癥瘕 痞块
白附子		祛 风痰 、 定 惊搐 、 解毒 散结止痛 ， 中风 痰 壅 、 口 眼 喎 斜 、 语言 涩 謇 ， 痰厥头痛 ， 偏正头痛 、 喉痹 咽痛 、 破伤风 ， 外治 瘰疬 痰核 、 毒蛇咬伤
硫黄		为 自然元素类 矿物 硫 族 自然 硫 。 采 挖 后 ， 加热 溶化 ， 除去 杂质 ， 或 用 含 硫 矿物 经 加工 制 得 。 外用 解 毒杀 虫 疗 疮 ， 内服 补火 助阳 通便 ， 外治 疥癣 、 秃疮 、 阴疽 恶疮 ， 内服 阳痿 足 冷 、 虚喘 冷哮 、 虚寒 便秘 。
天南星		燥湿化痰 、 祛风 止 痉 、 散结 消肿 ， 顽痰 咳嗽 、 风痰眩晕 、 中风 痰 壅 、 口眼歪斜 、 半身不遂 、 癫痫 、 惊风 、 破伤风 ， 生 用 外治 痈肿 、 蛇 虫 咬 伤
草乌		祛风除湿 、 温经止痛 ， 风寒湿痹 、 关节疼痛 、 心腹 冷 痛 、 寒疝 伤痛 及 麻醉 止痛
肉豆蔻		温 中行 气 、 涩肠止泻 ， 脾胃虚寒 、 久泻 不 止 、 脘 腹胀 痛 、 食少 呕吐
茴香		散寒止痛 、 温肾 缩 尿 、 理气 和胃 、 祛湿 利 浊 ， 寒疝 、 少 腹冷痛 、 肾虚腰痛 等
羚羊角		平肝熄风 、 清肝 明目 、 散 血 解毒 ， 高热 惊痫 、 神昏 痉 厥 、 子痫 抽搐 、 癫痫 发狂 、 头痛 眩晕 、 目赤 翳 障 、 温毒发斑 、 痈肿 疮 毒
莪术		行气破血 、 消积 止痛 ， 癥瘕 痞块 、 瘀血 经闭 、 食积 胀 痛 、 早期 宫颈癌
苦参		清热燥湿 、 杀 虫 、 利尿 ， 热痢 、 便血 、 黄疸 尿闭 、 赤白带下 、 阴肿 阴痒 、 湿疹 、 湿 疮 、 皮肤瘙痒 、 疥癣 麻风 ， 外治 滴虫性阴道炎
蒺藜		平肝 解郁 、 活血祛风 、 明目 、 止痒 的 作用 ， 头痛 眩晕 、 胸胁 胀 痛 、 乳 闭 乳痈 、 目赤 翳 障 ， 风疹 瘙 痒
乌药		顺 气 止痛 、 温肾散 寒 ， 胸 腹胀 痛 ， 气逆 喘急 、 膀胱虚冷 ， 遗尿 ， 疝气 ， 痛经
桂枝		发汗 解肌 、 温通 经脉 、 助阳 化气 、 平 冲 降气 ， 风寒感冒 、 脘 腹冷痛 、 血寒 经闭 、 关节 痹 痛 、 痰饮 、 水肿 、 心悸 、 奔豚
秦艽		祛 风湿 、 清 湿热 、 止 痹 痛 ， 风湿痹 痛 、 筋脉 拘挛 、 骨节 酸痛 、 日 晡 潮热 、 小儿疳积 发热
肉苁蓉		补肾阳 、 益 精血 、 润肠通便 ， 阳痿 、 不孕 、 腰膝酸软 、 筋骨 无力 、 肠燥便秘
郁金		行气化瘀 、 清心 解郁 、 利 胆 退 黄 ， 经闭 痛经 ， 胸 腹胀 痛 、 刺 痛 ， 热病神昏 、 癫痫 发狂 、 黄疸 尿 赤
木瓜		平肝 舒筋 、 和胃 化湿 ， 湿痹 拘挛 、 腰 膝关节 酸 重 疼痛 、 吐泻 转筋 、 脚气水肿
琥珀		镇惊安神 、 散瘀 止血 、 利水通淋
炙甘草		补脾和胃 、 益气复脉 ， 脾胃虚弱 、 倦怠 乏力 、 心动悸 、 脉 结代
硼砂		清热 消痰 、 解毒 防腐
血竭		祛瘀 定 痛 、 止血 生 肌 ， 跌 扑 折 损 、 内伤 瘀 痛 、 外伤 出血 不止
金银花		清热解毒 、 凉 散 风热 ， 痈肿 疔疮 、 喉痹 、 丹毒 、 热毒 血痢 、 温病 发热
山茱萸		补益肝肾 、 涩 精 固 脱 ， 眩晕耳鸣 、 腰膝酸痛 、 阳痿 遗精 、 遗尿 尿频 、 崩漏 带下 、 大汗 虚脱 、 内热 消渴
防己		利水 消肿 、 祛风止痛 ， 水肿 脚气 、 小便不利 、 湿疹 疮 毒 、 风湿痹 痛 、 高血压
枸杞子		滋补肝肾 、 益 精明 目 ， 虚劳 精亏 、 腰膝酸痛 、 眩晕耳鸣 、 内热 消渴 、 目昏 不 明
赤石脂		涩 肠 、 止血 、 生 肌 敛 疮 ， 久泻 久痢 、 大便 出血 、 崩漏 带下 ， 外治 疮疡 不 敛 、 湿疹 脓 水 浸淫
续断		补肝肾 、 强 筋骨 、 续 折伤 、 止 崩漏 ， 腰膝酸软 ， 风湿痹 痛 、 崩漏 、 跌 扑 损伤
天花粉		清热生津 、 排脓消肿 ， 热病 烦渴 、 肺 热 燥 咳 、 内热 消渴 、 疮疡 肿毒
大枣		补中益气 、 养血安神 ， 脾虚 食少 、 乏力 便 溏 、 妇人 脏躁 等
紫菀		润肺 下气 、 消痰 止咳 ， 痰 多 喘咳 、 新 久咳嗽 、 劳嗽 咳血
桑白皮		泻肺平喘 、 利水 消肿 ， 肺 热 喘咳 、 水 肿胀 满 尿 少 、 面目 肌肤 浮肿
橘红		散 寒 、 燥湿 、 利气 、 消痰 ， 风寒 痰嗽 、 喉痒 痰 多 、 食积 伤酒 、 呕 恶 痞 闷
五灵脂		行血 止痛 、 活血 止血 、 解毒 、 健脾 消积 ， 心腹 血气 诸 痛 、 崩漏 等
龙胆		清热燥湿 、 泻 肝胆 火 ， 湿热 黄疸 、 阴肿 阴痒 、 带下 、 强中 、 湿疹 瘙 痒 、 目赤 、 耳聋 、 胁痛 、 口苦 、 惊风 抽搐
麦芽		行气 消食 、 健脾 开胃 、 退 乳 消胀 ， 食积 不消 、 脘腹胀满 、 脾虚 食少 、 乳汁 郁积 ， 乳房 胀 痛 、 妇女 断乳
石斛		益胃生津 、 滋阴清热 ， 阴 伤津 亏 、 口干 烦渴 、 食少 干呕 、 病 后 虚热 、 目暗不明
石菖蒲		化湿 开胃 、 开窍豁痰 、 醒 神 益智 ， 脘痞 不 饥 、 噤口下痢 、 神昏癫痫 、 健忘 耳聋
党参		补中益气 、 健脾益肺 ， 脾 肺 虚弱 、 气 短 心悸 、 食少便溏 、 虚喘 咳嗽 、 内热 消渴
鳖甲		滋阴潜阳 、 软坚散结 、 退 热 除 蒸 ， 阴虚发热 、 劳热 骨蒸 、 虚风内动 、 经闭 、 癥瘕 、 久疟 疟母
蒲黄		止血 、 化痰 、 通淋 ； 吐血 、 衄血 、 咯血 、 崩漏 、 外伤 出血 、 经闭 痛经 、 脘 腹 刺 痛 、 跌 扑 肿 痛 、 血淋 涩 痛
牡丹皮		清热凉血 、 活血化瘀 ， 温热 发 斑 、 吐血 衄血 、 夜热 早 凉 、 无汗 骨蒸 、 经闭 痛经 、 痈肿 疮 毒 、 跌 扑 伤痛
地榆		凉血止血 、 解毒 敛 疮 ， 便血 、 痔 血 、 血痢 、 崩漏 、 水火烫伤 、 痈肿 疮 毒
牵牛		利水 消肿
牛蒡子		疏散 风热 、 宣肺 透疹 、 解毒利咽 ， 风热感冒 、 咳嗽痰多 、 麻疹 、 风疹 、 咽喉肿痛 、 痄腮 、 丹毒 、 痈肿 疮 毒
蝉蜕		散风 除 热 、 利咽 、 透疹 、 退翳 、 解痉 ， 风热感冒 、 咽痛 、 音 哑 、 麻疹 瘙 痒 、 目赤 翳 障 、 惊风 抽搐 、 破伤风
猪苓		利水渗湿 ， 小便不利 、 水肿 、 泄泻 、 淋浊 、 带下
鹿茸		壮 肾 助阳 、 益 精血 、 强 筋骨 、 调冲任 、 托 疮 毒 ， 阳痿 滑精 、 宫冷不孕 、 赢 瘦 、 神 疲 、 畏 寒 、 眩晕 耳鸣耳聋 、 腰脊 冷 痛 、 筋骨 痿 软 、 崩漏 带下 、 阴疽 不 敛
黄芪		补气固表 、 利尿 托 毒 、 排 脓 、 敛 疮 生 肌 ， 气虚 乏力 、 食少便溏 、 中气下陷 、 久泻 脱肛 、 便 血崩 漏 、 表虚自汗 、 气虚 水肿 、 痈疽 难 溃 、 久 溃 不 敛 、 血虚 痿黄 、 内热 消渴 、 慢性肾炎 蛋白尿 、 糖尿病
诃子		涩 肠 敛肺 、 降火 利咽 ， 久泻 久痢 、 便血 脱肛 、 肺虚 喘咳 、 久嗽 不止 、 咽痛 音 哑
蜈蚣		熄风 镇 痉 、 攻 毒 散结 、 通络止痛 ， 小儿惊风 、 抽搐 痉挛 、 中 风口 ? 、 半身不遂 、 破伤风 、 风湿 顽痹 、 疮疡 、 瘰疬 、 毒蛇咬伤
豆蔻		化湿 消痞 、 行 气温 中 、 开胃消食 ， 治疗 湿浊 中 阻 、 不思饮食 、 湿温 初 起 、 胸闷不饥 、 寒湿 呕逆 、 胸 腹胀 痛 、 食积 不消
柏子仁		养心安神 、 止汗 、 润 肠 ， 虚烦失眠 、 心悸怔忡 、 阴虚盗汗 、 肠燥便秘
地龙		清热定惊 、 平喘 、 利尿 ， 临床 高热 神昏 、 惊痫 抽搐 、 关节 痹 痛 、 肢体麻木 、 半身不遂 、 肺 热 喘咳 、 尿 少 水肿 、 高血压
寒水石		清热降火 、 利窍 消肿
白及		收敛止血 、 消肿生肌 ， 咯血 吐血 、 外伤 出血 、 疮疡 肿毒 、 皮肤 皲裂 、 肺结核 咯血 、 溃疡病 出血
蛇床子		温肾壮阳 、 燥湿 、 祛风 、 杀 虫 ， 阳痿 、 宫 冷 、 寒湿 带下 、 湿痹 腰痛 ， 外治 外 阴 湿疹 、 妇人 阴痒 、 滴虫性阴道炎
酸枣仁		补 肝 、 宁 心 、 敛汗 、 生津 ， 虚烦不眠 、 惊悸 多梦 、 体 虚 多汗 、 津 伤 口渴
何首乌		解毒 、 消痈 、 润肠通便 ， 瘰疬 疮 痈 、 风疹 瘙 痒 、 肠燥便秘 、 高 血脂
五倍子		敛肺 降火 、 涩肠止泻 、 敛汗 止血 、 收 湿 敛 疮 ， 肺虚 久咳 、 肺 热痰嗽 、 久泻 久痢 、 盗汗 、 消渴 、 便血 痔 血 、 外伤 出血 、 痈肿 疮 毒 、 皮肤 湿 烂
胡黄连		清 湿热 、 除 骨蒸 、 消 疳 热 ， 湿热 泻痢 、 黄疸 、 痔 疾 、 骨蒸潮热 、 小儿 疳 热
威灵仙		祛风除湿 、 通络止痛 ， 风湿痹 痛 、 肢体麻木 、 筋脉 拘挛 、 屈 伸 不利 、 骨 哽咽 喉
胡椒		温中散寒 、 下气 、 消痰 ， 胃寒呕吐 、 腹痛 泄泻 、 食欲不振 、 癫痫 痰 多
珍珠		安神 定 惊 、 明目 消 翳 、 解毒生肌 ， 惊悸 失眠 、 惊风 癫痫 、 目 生 云翳 、 疮疡 不 敛
穿山甲		通经 下乳 、 消肿 排 脓 、 搜风通络 ， 经闭 癥瘕 、 乳汁不通 、 痈肿 疮 毒 、 关节 痹 痛 、 麻木 拘挛
瓜蒌		清热 涤痰 、 宽胸散结 、 润燥 滑 肠 ， 临床 肺热咳嗽 、 痰浊 黄稠 、 结胸 痞满 、 乳痈 、 肺痈 、 肠 痈肿 痛 、 大便秘结
藁本		祛风 、 散 寒 、 除湿 、 止痛 ， 风寒感冒 、 巅 顶 疼痛 、 风湿 肢节 痹 痛
儿茶		生 肌 敛 疮 ， 溃疡 不 敛 等
芦荟		清 肝热 、 通便 ， 便秘 、 小儿疳积 、 惊风 ， 外治 湿癣
大腹皮		下气 宽中 、 行水 消肿 ， 湿阻气滞 、 脘 腹胀 闷 、 大便 不 爽 、 水 肿胀 满 、 脚气 浮肿 、 小便不利
茵陈		清 湿热 、 退 黄疸 ， 湿热 尿 少 、 温 疮 瘙 痒 、 传染性 黄疸型肝炎
白蔹		清热解毒 、 消痈 散结 ， 痈疽 发背 、 疔疮 、 瘰疬 、 水火烫伤
益智		温脾 止泻 、 摄 唾 涎 、 暖 肾 、 固精 缩 尿 ， 脾寒 泄泻 、 腹 中 冷 痛 、 口 多 唾 涎 、 肾虚 遗尿 、 小便频数 、 遗精 白浊
蟾酥		解毒 、 止痛 、 开窍 醒 神 ， 痈疽 疔疮 、 咽喉肿痛 、 中暑 神昏 、 腹痛 吐泻
款冬花		润肺 下气 、 止咳化痰 ， 新 久咳嗽 、 喘咳 痰 多 、 劳嗽 咳血
赤小豆		利水 消肿 、 解毒 排 脓 ， 水 肿胀 满 、 脚气 肢肿 、 黄疸 尿 赤 、 风湿热 痹 、 痈肿 疮 毒 、 肠痈腹痛
乌头		祛风 、 散 寒 、 燥湿 、 益火助 阳 ， 风寒湿痹 等
艾叶		散寒止痛 、 温经 止血 ， 少 腹冷痛 、 经 寒 不 调 、 宫冷不孕 、 吐血 、 衄血 、 崩漏 经 多 、 妊娠 下血 ， 外治 皮肤瘙痒
射干		清热解毒 、 消痰 、 利咽 ， 热毒 痰 火 郁结 、 咽喉肿痛 、 痰涎壅盛 、 咳嗽气喘 等
甘遂		泻 水 逐 饮 ， 水 肿胀 满 、 胸 腹 积水 、 痰饮 积聚 、 气逆 喘咳 、 二 便 不 利
草果		燥湿 温中 、 除痰 截疟 ， 寒湿 内阻 、 脘 腹胀 痛 、 痞满 呕吐 、 疟疾 寒热
天竺黄		清热 豁痰 、 凉 心 定 惊 ， 热病神昏 、 中风 痰迷 、 小儿 痰 热 惊痫 、 抽搐 、 夜啼
五加皮		祛 风湿 ， 补肝肾 ， 强 筋骨 ， 风湿痹 痛 ， 筋骨 痿 软 ， 小儿 行迟 ， 水肿 、 脚气
三七		散瘀 止血 、 消肿 定 痛 ， 咯血 、 吐血 、 衄血 、 便血 、 崩漏 、 外伤 出血 、 胸 腹 刺 痛 、 跌 扑 肿 痛
薏苡仁		健脾渗湿 、 除 痹 止泻 、 清热排脓 ， 水肿 、 脚气 、 小便不利 、 湿痹 拘挛 、 脾虚泄泻 、 肺痈 、 肠痈 、 扁平疣
延胡索		活血 、 利气 、 止痛 ， 胸胁 、 脘腹疼痛 ， 经闭 痛经 、 产 后 瘀 阻 、 跌 扑 肿 痛
葱白		辛温解表
草豆蔻		燥湿 健脾 、 温胃 止 呕 ， 寒湿 内阻 、 脘腹胀满 冷 痛 、 嗳气 呕逆 、 不思饮食
蔓荆子		疏散 风热 、 清利头目 ， 风热 感冒头痛 、 齿龈 肿 痛 、 目赤 多 泪 、 目暗不明 、 头晕目眩
钩藤		清热 平肝 、 熄风 定 惊 ， 头痛 眩晕 、 感冒夹惊 、 惊痫 抽搐 、 妊娠 子痫 、 高血压
木鳖子		散结 消肿 、 攻 毒 疗 疮 ， 疮疡 肿毒 、 乳痈 、 瘰疬 、 痔漏 、 秃疮
补骨脂		温肾助阳 、 纳气 、 止泻 ， 阳痿 遗精 、 遗尿 尿频 、 腰 膝 冷 痛 、 肾虚 作 喘 、 五更泄泻 ， 外治 白癜风 、 斑秃
阿魏		消积 、 散 痞 、 杀 虫 ， 瘀血 癥瘕 、 腹 中 痞块 、 虫积腹痛
使君子		杀 虫 消积 ， 蛔虫 、 蛲虫病 、 虫积腹痛 、 小儿疳积
斑蝥		破血 消 癥 、 攻 毒 蚀疮 、 引 赤 发泡 ， 癥瘕 肿块 、 积 年 顽癣 、 瘰疬 、 赘疣 、 痈疽 不 溃 、 恶疮 死 肌
郁李仁		润燥 滑 肠 、 下气 、 利水 ， 津 枯 肠 燥 、 食积 气滞 、 腹胀 便秘 、 水肿 、 脚气 、 小便不利
瞿麦		利尿 通淋 、 破血 通经 ， 热淋 、 血淋 、 石淋 、 小便不通 、 淋沥 涩 痛 、 月经 闭 止
益母草		活血调经 、 利尿 消肿 ， 月经不调 、 痛经 、 经闭 、 恶露不尽 、 水肿 尿 少 、 急性 肾炎水肿
高良姜		温胃散寒 、 消食 止痛 ， 脘 腹冷痛 、 胃寒呕吐 、 嗳气吞酸
芜荑		杀 虫 、 消积 、 散寒止泻 ， 虫积腹痛 、 小儿 疳泻
百合		养阴润肺 、 清心安神 ， 阴虚久 咳 、 痰中带血 、 虚烦 惊悸 、 失眠多梦 、 精神 恍惚
芫花		泻 水 逐 饮 、 解 毒杀 虫 ， 水 肿胀 满 、 胸 腹 积水 、 痰饮 积聚 、 气逆 喘咳 、 二 便 不利 ， 外治 疥癣 秃疮 、 冻疮
竹叶		清热 除 烦 、 生津利 尿 、 化痰止咳 、 降逆止呕 、 疏风通络
磁石		平肝潜阳 、 聪 耳 明目 、 镇惊安神 、 纳气平喘 ， 头晕目眩 、 视 物 昏花 、 耳鸣耳聋 、 惊悸 失眠 、 肾虚 气喘
川楝子		疏肝 行气 、 驱虫 ， 胸胁 、 脘 腹胀 痛 、 疝 痛 、 虫积腹痛
干漆		破 瘀血 、 消积 、 杀 虫 ， 妇女 闭经 、 瘀血 癥瘕 、 虫积腹痛
枇杷叶		清肺止咳 、 降逆止呕 ， 肺热咳嗽 、 气逆 喘急 、 胃热 呕逆 、 烦热 口渴
旋覆花		降气 、 消痰 、 行水 、 止 呕 ， 风寒咳嗽 、 痰饮 蓄 结 、 胸 膈 痞满 、 喘咳 痰 多 、 呕吐 噫气 、 心下痞硬
竹茹		清热化痰 、 除 烦 止 呕 ， 痰 热 咳嗽 、 胆火 挟 痰 、 烦热 呕吐 、 惊悸 失眠 、 中风 痰迷 、 舌强 不语 、 胃热呕吐 、 妊娠恶阻 、 胎动不安
木贼		疏 风热 、 退 目 翳 ， 风热 目赤 、 迎风流泪 、 目 生 云翳
白芥		温中散寒 ， 咳嗽 、 胃痛 、 腹冷痛 等
巴戟天		补肾阳 、 壮 筋骨 、 祛 风湿 ， 阳痿 遗精 、 宫冷不孕 、 月经不调 、 少 腹冷痛 、 风湿痹 痛 、 筋骨 痿 饮 等
檀香		行 气温 中 、 开胃 止痛 ， 寒凝气滞 、 胸痛 、 腹痛 、 胃痛 食少 、 冠心病 、 心绞痛
槐花		凉血止血 、 清肝泻火 ， 便血 、 痔 血 、 血痢 、 崩漏 、 吐血 、 衄血 、 肝热 目赤 、 头痛 眩晕
芡实		固肾涩精 、 补脾止泄 、 祛湿 止带 ， 梦遗 滑精 、 遗尿 尿频 、 脾虚 久泻 、 白浊 、 带下
天冬		养阴润燥 、 清肺 生津 ， 肺 燥 干咳 、 顿咳 痰 黏 、 咽干口渴 、 肠燥便秘
龙齿		镇惊安神 、 除 烦热 ， 惊痫 、 癫狂 等
紫草		凉血 、 活血 、 解毒透疹 ， 血 热毒 盛 、 斑疹 紫 黑 、 麻疹 不 透 、 疮疡 、 湿疹 、 水火烫伤
石决明		平肝潜阳 、 清肝 明目 ， 头痛 眩晕 、 目赤 翳 障 、 视 物 昏花 、 青盲 雀目
苏木		行血 破 瘀 、 消肿止痛 ， 闭经 、 痛经 、 产 后 瘀 阻 、 胸 腹 刺 痛 、 外伤 肿 痛
熊胆		清热 、 镇 痉 、 明目 、 杀 虫 ， 热 黄 、 暑泻 、 小儿 惊痫 等
绿豆		清热解毒 、 消暑 利水 ， 暑热 烦渴 等
蛇蜕		祛风 、 定 惊 、 解毒 、 退翳 ， 小儿 惊痫 、 抽搐 痉挛 、 翳 障 、 喉痹 、 疔 肿 、 皮肤瘙痒
猪牙皂		祛痰 开窍 、 散结 消肿 ， 中 风口 噤 、 昏迷不醒 、 癫痫 痰 盛 、 关窍 不 通 、 喉痹 痰 阻 、 顽 痰喘 咳 、 咯痰不爽 、 大便燥结 ， 外治 痈肿
姜黄		破血 行气 、 通经止痛 ， 胸胁 刺 痛 、 闭经 、 癥瘕 、 风湿 肩 臂 疼痛 、 跌 扑 肿 痛
萝卜		祛湿 利水 、 消食
小茴香		散寒止痛 、 理气 和胃 ， 寒疝 腹痛 、 睾丸 偏坠 、 痛经 、 少 腹冷痛 、 脘 腹胀 痛 、 食少 吐泻 、 睾丸鞘膜积液
自然铜		散瘀 、 接骨 、 止痛 ， 跌 扑 肿 痛 、 筋骨 折伤
白鲜皮		清热燥湿 、 祛风 解毒 ， 湿 热疮 毒 、 黄水 淋漓 、 风疹 、 疥癣 疮 癞 、 风湿热 痹 、 黄疸 尿 赤
松香		祛风 、 燥湿 、 清热解毒 、 生 肌 、 止痛 、 驱虫 ， 痈疽 、 疔毒 等
桑寄生		补肝肾 、 强 筋骨 、 除 风湿 、 安胎 ， 风湿痹 痛 、 腰膝酸软 、 筋骨 无力 、 崩漏 经 多 、 妊娠 漏 血 、 胎动不安 、 高血压
百部		润肺 下气 止咳 、 杀 虫 ， 新 久咳嗽 、 肺痨 咳嗽 、 百日咳 ， 外 头虱 、 体虱 、 蛲虫病 、 阴痒
蜂房		祛风 、 攻 毒 、 杀 虫 、 止痛 ， 龋齿 牙痛 、 疮疡 肿毒 、 乳痈 、 瘰疬 、 皮肤 顽癣 、 鹅掌风
甘松		理气止痛 、 开 郁醒 脾 ， 脘腹胀满 、 食欲不振 、 呕吐 ， 外治 牙痛 、 脚肿
泽兰		活血化瘀 、 行水 消肿 ， 月经不调 、 经闭 、 痛经 、 产 后 瘀血腹痛 、 水肿
鸡子		滋阴润燥 、 养血安胎 ， 热病 烦闷 、 燥 咳 声哑 、 目赤 咽痛 等
牵牛子		泻 水 通便 、 消痰 涤 饮 、 杀 虫 攻 积 ， 水 肿胀 满 、 二 便 不 通 、 痰饮 积聚 、 气逆 喘咳 、 虫积腹痛 、 蛔虫 、 绦虫病
海螵蛸		收敛止血 、 涩 精 止带 、 制 酸 、 敛 疮 ， 胃痛 吞酸 、 吐血 衄血 、 崩漏 便血 、 遗精 滑精 、 赤白带下 、 溃疡病 ， 外治 损伤 出血 、 疮 多 脓 汁
常山		截疟 、 劫 痰 ， 疟疾
青蒿		清热解暑 、 除 蒸 、 截疟 ， 暑邪 发热 、 阴虚发热 、 夜热 早 凉 、 骨蒸 痨 热 、 疟疾 寒热 、 湿热 黄疸
川贝母		清热 润肺 、 化痰止咳 ， 肺 热 燥 咳 、 干咳少痰 、 阴虚劳 嗽 、 咯痰 带 血
樟脑		通窍 、 杀 虫 、 止痛 、 辟 秽 ， 心 腹胀 痛 、 脚气 、 疮疡 疥癣 等
覆盆子		益肾 、 固精 、 缩 尿 ， 肾虚 遗尿 、 小便频数 、 阳痿 早泄 、 遗精 滑精
荜茇		温中散寒 、 下气 止痛 ， 脘 腹冷痛 、 呕吐 、 泄泻 、 偏头痛 ， 外治 牙痛
海藻		软坚散结 、 消痰 、 利水 ， 瘿瘤 、 瘰疬 、 睾丸 肿 痛 、 痰 饮水 肿
紫苏叶		解表散寒 、 行气和胃 ， 风寒感冒 、 咳嗽 呕 恶 、 妊娠呕吐 、 鱼 蟹 中毒
淡竹叶		清心 除 烦 、 利尿 ， 热病 烦渴 、 小便赤涩 淋 痛 、 口舌生疮
雷丸		杀 虫 消积 ， 绦虫 、 钩虫 、 蛔虫病 、 虫积腹痛 、 小儿疳积
蒲公英		清热解毒 、 消肿散结 、 利尿 通淋 ， 疔疮 肿毒 、 乳痈 、 瘰疬 、 目赤 、 咽痛 、 肺痈 、 肠痈 、 湿热 黄疸 、 热淋 涩 痛
鸡内金		健脾消食 、 涩精止遗 ， 食积 不消 、 呕吐 泻痢 、 小儿疳积 、 遗尿 、 遗精
胆矾		催吐 、 祛 腐 解毒
青木香		平 肝气 痛 、 解毒消肿 ， 眩晕 头痛 等
桑叶		疏散 风热 、 清肺润燥 、 清肝 明目 ， 风热感冒 、 肺 热 燥 咳 、 头晕 头痛 、 目赤 昏花
鹿角		温 肾阳 、 强 筋骨 、 行血 消肿 ， 阳痿 遗精 、 腰脊 冷 痛 、 阴疽 疮疡 、 乳痈 初 起 、 瘀 血肿 痛
蕤仁		养肝明目 、 疏风散热 ， 目赤 肿 痛 、 睑 眩 赤 烂 、 目 暗 羞明
夏枯草		清 火 、 明目 、 散结 、 消肿 ， 目赤 肿 痛 、 目珠 夜 痛 、 头痛 眩晕 、 瘰疬 、 瘿瘤 、 乳 痈肿 痛 、 甲状腺肿大 、 淋巴结 结核 、 乳腺增生 、 高血压
通草		清热 利尿 、 通气 下乳 ， 湿热 尿 赤 、 淋病 涩 痛 、 水肿 尿 少 、 乳汁 不 下
决明子		清肝 明目 、 润肠通便 ， 风热 赤眼 等
人中白		清热 、 降火 、 消瘀 ， 劳热 、 肺痿 等
芦根		清热生津 、 除 烦 、 止 呕 、 利尿 ， 热病 烦渴 、 胃 热呕 哕 、 肺热咳嗽 、 肺痈 吐 脓 、 热淋 涩 痛
虎骨		追 风 定 痛 、 健 骨 镇 惊 ， 历节风 痛 、 惊悸 癫痫 、 痔 瘘 脱肛 等
桑螵蛸		益肾 固精 、 缩 尿 、 止 浊 ， 遗精 滑精 、 遗尿 尿频 、 小便 白浊
炉甘石		解毒 明目 退翳 、 收 湿 止痒 敛 疮 ， 目赤 肿 痛 、 眼 缘 赤 烂 、 翳 膜 胬肉 、 溃疡 不 敛 、 脓 水 淋漓 、 湿 疮 、 皮肤瘙痒
昆布		软坚散结 、 消痰 、 利水 ， 瘿瘤 、 瘰疬 、 睾丸 肿 痛 、 痰 饮水 肿
狗脊		补肝肾 、 强 腰 膝 、 祛 风湿 ， 腰膝酸软 、 下肢 无力 、 风湿痹 痛
炮姜		温中散寒 、 温经 止血 ， 脾胃虚寒 、 腹痛 吐泻 、 吐 衄 崩漏 、 阳虚失血 等
莲子		补脾止泻 、 益肾 涩 精 、 养心安神 ， 脾虚 久泻 、 遗精 带下 、 心悸失眠
罂粟壳		敛肺 、 涩 肠 、 定 痛 ， 久咳 、 久泻 、 脱肛 、 脘腹疼痛
百草霜		止血 、 消积 、 清热 ， 吐血 等
白薇		清热凉血 、 利尿 通淋 、 解毒 疗 疮 ， 温邪 伤 营 发热 、 阴虚发热 、 骨蒸 劳热 、 产 后 血虚发热 、 热淋 、 血淋 、 痈疽肿毒
白扁豆		健脾化湿 、 和中 消暑 ， 临床 脾胃虚弱 、 食欲不振 、 大便 溏 泻 、 白带 过 多 、 暑湿 吐泻 、 胸闷腹胀
莱菔子		消食 除 胀 、 降气化痰 ， 饮食 停滞 、 脘 腹胀 痛 、 大便秘结 、 积滞 泻痢 、 痰 壅 喘咳
土茯苓		除湿 、 解毒 、 通利关节 ， 湿热 淋浊 、 带下 、 痈肿 、 瘰疬 、 疥癣 、 梅毒 及 汞 中毒 所 致 的 肢体 拘挛 、 筋骨疼痛
荷叶		清暑 解暑 、 升 发 清阳 、 凉血止血 ， 暑热 烦渴 、 暑湿 泄泻 、 脾虚泄泻 、 血热 吐 衄 、 便 血崩 漏
香薷		发汗解表 、 和中 利湿 ， 暑湿感冒 、 恶寒发热 、 头痛 无汗 、 腹痛 吐泻 、 小便不利
茺蔚子		活血调经 、 清肝 明目 ， 月经不调 、 经闭 、 痛经 、 目赤 翳 障 、 头晕 胀 痛
赭石		平肝潜阳 、 降逆 、 止血 ， 眩晕耳鸣 、 呕吐 、 噫气 、 呃逆 、 喘息 、 吐血 、 衄血 、 崩漏 下血
女贞子		滋补肝肾 、 明目 乌发 ， 眩晕耳鸣 、 腰膝酸软 、 须发 早 白 、 目暗不明
鹿角胶		温 补肝肾 、 益精养 血 ， 肝 肾 气不足 所 致 的 腰 膝 酸 冷 、 阳痿 遗精 、 虚劳 羸 瘦 、 崩漏 下血 、 便血 尿血 、 阴疽 肿 痛
水蛭		破血 、 逐瘀 、 通经 ， 癥瘕 痞块 、 血瘀经闭 、 跌 扑 损伤
藜芦		涌吐风痰 、 清热解毒 、 杀 虫 ， 中风 痰 涌 、 风痫 癫 疾 、 黄疸 等
青葙子		清肝 、 明目 、 退翳 ， 肝热 目赤 、 眼生 翳 膜 、 视 物 昏花 、 肝火眩晕
白茅根		凉血止血 、 清热 利尿 ， 血热 吐血 、 衄血 、 尿血 、 热病 烦渴 、 黄疸 、 水肿 、 热淋 涩 痛 、 急性 肾炎水肿
漏芦		清热解毒 、 消痈 、 下乳 、 舒筋 通脉 ， 乳 痈肿 痛 、 痈疽 发背 、 瘰疬 疮 毒 、 乳汁不通 、 湿痹 拘挛
大豆		健脾 宽中 、 解毒消肿 、 利水 消积 ， 疳积 、 泻痢 等
葶苈子		泻肺平喘 、 行水 消肿 ， 痰 涎 壅 肺 、 喘咳 痰 多 、 胸胁胀满 、 不得平卧 、 胸 腹 水肿 、 小便不利 、 肺 原 性 心脏病 水肿
石韦		利尿 通淋 、 清热止血 ， 热淋 、 血淋 、 石淋 、 小便不通 、 淋沥 涩 痛 、 吐血 、 衄血 、 尿血 、 崩漏 、 肺 热 喘咳
牛蒡		清肺止咳 、 清热解毒 、 清肝 熄风 、 软坚散结 ， 风毒 面肿 、 头晕 等
蓖麻子		消肿 拔毒 、 泻下 通 滞 ， 痈疽肿毒 、 喉痹 、 瘰疬 、 大便燥结
花椒		温中 止痛 、 杀虫止痒 ， 脘 腹冷痛 、 呕吐泄泻 、 虫积腹痛 ， 蛔虫 症 ， 外治 湿疹 瘙 痒
冬葵子		祛寒
紫苏子		降气 消痰 、 平喘 、 润 肠 ， 痰 壅 气逆 、 咳嗽气喘 、 肠燥便秘
谷精草		疏散 风热 、 明目 、 退翳 ， 风热 目赤 、 肿 痛 羞明 、 眼生 翳 膜 、 风热头痛
皂角刺		消肿 托 毒 、 排 脓 、 杀 虫 ， 痈疽 初 起 或 脓 成 不 溃 ， 外治 疥癣 麻风
荜澄茄		温中散寒 、 行气止痛 ， 胃寒 呕逆 、 脘 腹冷痛 、 寒疝 郁滞 、 小便浑浊
小麦		养心 、 益肾 、 除 热 、 止渴 ， 脏躁 、 烦热 、 消渴 等
铅丹		解毒 祛 腐 、 收 湿 敛 疮 、 坠 痰 镇 惊 的 作用
巴豆霜		峻下 积滞 、 逐水 消肿 、 豁痰 利咽 ， 寒积便秘 、 乳 食 停滞 、 下腹 水肿 、 二 便 不 通 、 喉风 、 喉痹
侧柏叶		凉血止血 、 生发 乌发 ， 吐血 衄血 、 咯血 、 便血 、 崩漏 下血 、 血热 脱发 、 须发 早 白
淫羊藿		补肾阳 、 强 筋骨 、 祛 风湿 ， 阳痿 遗精 、 筋骨 痿 软 、 风湿痹 痛 、 麻木 拘挛 、 更年期 高血压
阳起石		温肾壮阳
山豆根		清热解毒 、 消肿 利咽 ， 火毒 蕴 结 、 咽喉肿痛 、 齿龈 肿 痛
紫石英		镇 心安 神 、 温肺 、 暖 宫 ， 失眠多梦 、 心悸 易 惊 、 肺虚 咳喘 、 宫寒 不孕
安息香		开窍 清 神 、 行气活血 、 止痛 ， 中风痰厥 、 气 郁暴厥 、 中恶 昏迷 、 心腹 疼痛 、 产后血晕 、 小儿惊风
鹤虱		杀 虫 消积 ， 蛔虫 、 蛲虫 、 绦虫病 、 虫积腹痛 、 小儿疳积
石榴皮		涩肠止泻 、 止血 、 驱虫 ， 久泻 、 久痢 、 便血 、 脱肛 、 崩漏 、 白带 、 虫积腹痛
槐角		清热泻火 、 凉血止血 ， 肠 热 便血 、 痔 肿 出血 、 肝热 头痛 、 眩晕 目赤
牛胆		清肝 明目 、 解毒消肿 、 利 胆 通 肠 、 清热生津 ， 风热 目 疾 、 小儿惊风 、 痈肿 等
地肤子		清热利湿 、 祛风止痒 ， 小便涩痛 、 阴痒 带下 、 湿疹 、 皮肤瘙痒
黄精		补气 养阴 、 健脾 、 润肺 、 益肾 ， 脾胃虚弱 、 体倦乏力 、 口干 食少 、 肺虚 燥 咳 、 精血 不足 、 内热 消渴
王不留行		活血通经 、 下乳 消肿 ， 乳汁 不 下 、 经闭 、 痛经 、 乳 痈肿 痛
茜草		凉血 、 止血 、 祛瘀 、 通经 ， 吐血 、 衄血 、 崩漏 、 外伤 出血 、 经闭 瘀 阻 、 关节 痹 痛 、 跌 扑 肿 痛
紫河车		温肾 补 精 、 益气养血 ， 虚损 羸 瘦 、 骨蒸 盗汗 、 咳嗽气喘 、 食 少气 短 、 阳痿 遗精 、 不孕 少 乳
秦皮		清热燥湿 、 收涩 、 明目 ， 热痢 、 泄泻 、 赤白带下 、 目赤 肿 痛 、 目 生 翳 障
瓜蒂		涌吐 、 去 湿热 、 行水 消肿 ， 痰 涎 宿食 等
商陆		逐水 消肿 、 通利二 便 、 解毒散结 ， 水 肿胀 满 、 二 便 不通 ， 外治 痈肿 疮 毒
马兜铃		清肺 降气 、 止咳平喘 、 清肠 消 痔 ， 肺 热 喘咳 、 痰中带血 、 肠 热 痔 血 、 痔疮 肿 痛
玄明粉		泻热 通便 、 润燥 软坚 、 清 火 消肿 ， 临床 实热 便秘 、 大便燥结 、 积滞 腹痛 ， 外治 咽喉肿痛 、 口舌生疮 、 牙龈 肿 痛 、 目赤 、 痈肿 、 丹毒
降香		行气活血 、 止痛 、 止血 ， 脘腹疼痛 、 肝郁胁痛 、 胸痹 刺 痛 、 跌 扑 损伤 、 外伤 出血
车前		清热 利尿 、 祛痰 、 凉血 、 解毒 ， 淋证 等
海桐皮		祛 风湿 、 通 经络 、 杀 虫 ， 风湿痹 痛 等
母丁香		温中 降逆 、 补肾助阳 ， 脾胃虚寒 、 呃逆 呕吐 、 食少 吐泻 、 心腹 冷 痛 、 肾虚 阳痿
葫芦		祛湿 利 水
桑枝		祛 风湿 、 利 关节 ， 肩 臂 、 关节 酸痛 麻木
苦杏仁		降气 止咳平喘 、 润肠通便 ， 咳嗽气喘 、 胸满 痰 多 、 血虚 津 枯 、 肠燥便秘
蜗牛		清热解毒 、 镇 惊 、 消肿
鸡血藤		补血 、 活血 、 通络 ， 月经不调 、 血虚 萎黄 、 麻木 瘫痪 、 风湿痹 痛
玉竹		养阴润燥 、 生津止渴 ， 肺 胃阴 伤 、 燥 伤 咳嗽 、 咽干口渴 、 内热 消渴
禹余粮		涩肠止泻 、 收敛止血 ， 久泻 、 久痢 、 崩漏 、 白带
竹沥		清热 滑痰 、 镇 惊 利窍 ， 中风 痰迷 、 肺 热痰 壅 、 惊风 、 癫痫 等
法半夏		燥湿化痰 ， 痰 多 咳喘 、 痰饮眩晕 、 风痰眩晕 、 痰厥头痛
苍耳子		散风 除湿 、 通鼻 窍 ， 风寒头痛 、 鼻渊 流 涕 、 风疹 瘙 痒 、 湿痹 拘挛
板蓝根		清热解毒 、 凉血 利咽 ， 温毒发斑 、 舌 绛紫 暗 、 痄腮 、 喉痹 、 烂喉丹痧 、 大头 瘟疫 、 丹毒 、 痈肿
金樱子		固精 涩 尿 、 涩肠止泻 ， 遗精 滑精 、 遗尿 尿频 、 崩漏 带下 、 久泻 久痢
大麦		和胃 、 宽肠 、 利水
胆南星		清 火 化痰 、 熄风 定 惊 ， 痰 热 咳嗽 、 咯痰 黄稠 、 中风 痰迷 、 癫狂 惊痫
刘寄奴		破血 通经 、 敛 疮 消肿 、 醒脾 消食 ， 经闭 癥瘕 、 胸 腹胀 痛 、 痈 毒 脓肿 等 证
牡丹		清热凉血
浮萍		宣散风 热 、 透疹 、 利尿 ， 麻疹 不 透 、 风疹 瘙 痒 、 水肿 尿 少
冬瓜		利水 消痰 、 清热解毒 ， 水肿 等
薤白		通阳散 结 、 行气 导 滞 ， 胸痹 疼痛 、 痰饮 咳喘 、 泄痢 后重
零陵香		祛 风寒 、 辟 秽浊 ， 伤寒 等
大风子		祛风燥湿 、 攻 毒杀 虫 ， 麻风 等
麻黄根		止汗 ， 自汗 、 盗汗
苍耳		祛风 散热 、 解 毒杀 虫 ， 头风 、 湿痹 拘挛 、 热毒 疮疡 等
海金沙		清利湿热 、 通淋 止痛 ， 热淋 、 砂淋 、 石淋 、 血淋 、 膏淋 、 尿道 涩 痛
虻虫		逐瘀 、 破 积 通经
象皮		止血 、 敛 疮 ， 外伤 出血 、 溃疡
白前		降气 、 消痰 、 止咳 ， 肺气 壅 实 、 咳嗽痰多 、 胸满 喘急
虎杖		祛风 利湿 、 散瘀 定 痛 、 止咳化痰 ， 关节 痹 痛 、 湿热 黄疸 、 经闭 、 癥瘕 、 水火烫伤 、 跌 扑 损伤 、 痈肿 疮 毒 、 咳嗽痰多
蓖麻		为 大戟科 蓖麻属 植物 ， 其 干燥 成熟 种子 为 中药 蓖麻子 。
紫花地丁		清热解毒 、 凉血 消肿 ， 疔疮 肿毒 、 痈疽 发背 、 丹毒 、 毒蛇咬伤
马齿苋		清热解毒 、 凉血止血 ， 热毒 血痢 、 痈肿 疔疮 、 湿疹 、 丹毒 、 蛇 虫 咬 伤 、 便血 、 痔 血 、 崩漏 下血
广藿香		芳香化浊 、 开胃 止 呕 、 发表 解暑 ， 湿浊 中 阻 、 脘痞 呕吐 、 暑湿 倦怠 、 胸闷 不 舒 、 寒湿 闭暑 、 腹痛 吐泻
蛤蚧		补肺 益肾 、 纳气 定喘 、 助 阳益 精 ， 虚 喘气 促 、 劳嗽 咳血 、 阳痿 遗精
谷芽		消食 和中 、 健脾 开胃 ， 食积 不消 、 腹胀 口臭 、 脾胃虚弱 、 不 饥 食少
马钱子		通络止痛 、 散结 消肿 ， 风湿 顽痹 、 麻木 瘫痪 、 跌 扑 损伤 、 痈疽 肿 痛 、 小儿麻痹后遗症 、 类风湿 性 关节痛
金钱草		清利湿热 、 通淋 、 消肿 ， 热淋 、 沙 淋 、 尿 涩 作 痛 、 黄疸 尿 赤 、 痈肿 疔疮 、 毒蛇咬伤 、 肝胆 结石 、 尿路结石
胡芦巴		温肾 、 祛寒 、 止痛 ， 肾脏 虚 冷 、 小腹 冷 痛 、 小肠 疝气 、 寒湿脚气
浙贝母		清热散结 、 化痰止咳 ， 风热犯肺 、 痰 火 咳嗽 、 肺痈 、 乳痈 、 瘰疬 、 疮 毒
锁阳		补肾阳 、 益 精血 、 润肠通便 ， 腰 膝 痿 软 、 阳痿 滑精 、 肠燥便秘
桑椹		补血 滋阴 、 生津润燥 ， 眩晕耳鸣 、 心悸失眠 、 须发 早 白 、 津 伤 口渴 、 内热 消渴 、 血虚 便秘
鬼箭羽		破血 、 通经 、 杀 虫 ， 经闭 、 癥瘕
石榴		涩肠止泻
密蒙花		清热 养肝 、 明目 退翳 ， 目赤 肿 痛 、 多 泪 羞明 、 眼生 翳 膜 、 肝虚目暗 、 视 物 昏花
太子参		益气健脾 、 生津润 肺 ， 脾虚 体 倦 、 食欲不振 、 病 后 虚弱 、 气 阴不足 、 自汗 口渴 、 肺 燥 干咳
辛夷		散 风寒 、 通鼻 窍 ， 风寒头痛 、 鼻塞 、 鼻渊 、 鼻流浊涕
青礞石		坠 痰 下气 、 平肝 镇 惊 ， 顽痰 胶 结 、 咳逆 喘急 、 癫痫 发狂 、 烦躁 胸闷 、 惊风 抽搐 ， 多 入 丸 散 服
莲须		固肾涩精 ， 遗精 滑精 、 带下 、 尿频
大青叶		清热解毒 、 凉血 消 斑 ， 温邪 入 营 、 高热 神昏 、 发 斑 发 疹 、 黄疸 、 热痢 、 痄腮 、 喉痹 、 丹毒 、 痈肿
皂矾		燥湿化痰 、 消积 杀 虫 、 止血 补血 、 解毒 敛 疮
车前草		清热 利尿 、 祛痰 、 凉血 、 解毒 ， 水肿 尿 少 、 热淋 涩 痛 、 暑湿 泻痢 、 痰 热 咳嗽 、 吐血 衄血 、 痈肿 疮 毒
藕节		止血 、 消瘀 ， 吐血 、 咯血 、 衄血 、 尿血 、 崩漏
败酱		清热解毒
橘核		理气 、 散结 、 止痛 ， 小肠 疝气 、 睾丸 肿 痛 、 乳 痈肿 痛
淡豆豉		解表 、 除 烦 、 宣发 郁热 ， 感冒 、 寒热 头痛 、 烦躁 胸闷 、 虚烦不眠
松节		祛风 、 燥湿 、 舒筋 、 通络 ， 历节风 痛 等
土鳖虫		破 瘀血 、 续 筋骨
莨菪		杀虫止痒 、 解 毒杀 疟 、 镇痛 解痉 ， 疥癣 、 虫 疾
白头翁		清热解毒 、 凉血止痢 ， 热毒 血痢 、 阴痒 带下 、 阿米巴 痢
仙茅		补肾阳 、 强 筋骨 、 祛 寒湿 ， 阳痿 精冷 、 筋骨 痿 软 、 腰 膝 冷痹 、 阳虚 冷泻
小蓟		凉血止血 、 祛瘀消肿 ， 吐血 、 衄血 、 尿血 、 便血 、 崩漏 下血 、 外伤 出血 、 痈肿 疮 毒
大蒜		行 滞气 、 暖 脾胃 、 消 症 积 、 解毒 、 杀 虫
白果		敛肺 定喘 、 止带 浊 、 缩小 便 ， 痰 多 喘咳 、 带下 白浊 、 遗尿 、 尿频
忍冬藤		清热解毒 、 疏风通络 ， 温病 发热 、 热毒 血痢 、 痈肿 疮疡 、 风湿热 痹 、 关节 红肿 热 痛
北沙参		养阴清肺 、 益胃生津 ， 肺 热 燥 咳 、 虚痨 久咳 等
野菊花		清热解毒 ， 疔疮 痈肿 、 目赤 肿 痛 、 头痛 眩晕
马勃		清肺 利咽 、 止血 ， 风 热郁 肺 咽痛 、 咳嗽 、 音 哑 ， 外治 鼻衄 、 创伤 出血
佛手		舒肝理气 、 和胃止痛 ， 肝胃气滞 、 胸胁 胀 痛 、 胃脘 痞满 、 食少 呕吐
煅石膏		收 湿 、 生 肌 、 敛 疮 、 止血 ， 溃疡 不 敛 、 湿疹 瘙 痒 、 水火烫伤 、 外伤 出血
淡竹		清心 火 、 除 烦热 、 利小便
蜂蜜		补 中 、 润燥 、 止痛 、 解毒 ， 脘 腹 虚 痛 、 肺 燥 干咳 、 肠燥便秘 ， 外治 疮疡 不 敛 、 水火烫伤
两头尖		祛 风湿 、 消 痈肿 ， 风寒湿痹 、 四肢拘挛 、 骨节 疼痛 ， 痈肿 溃烂
楮实子		补肾 清肝 、 明目 、 利尿 ， 腰膝酸软 、 虚 劳骨蒸 、 头晕 目昏 、 目 生 翳 膜 、 水 肿胀 满
龙眼肉		补益心脾 、 养血安神 ， 气血不足 、 心悸怔忡 、 健忘失眠 、 血虚 萎黄
卷柏		活血通经 ， 临床 经闭 痛经 、 癥瘕 痞块 、 跌打损伤
甜瓜子		散结 、 消瘀 、 清肺 、 润 肠 ， 腹内 结 聚 、 肠痈 等
丝瓜		清热解毒 、 化痰 凉血 ， 热病 烦渴 等
梅花		开 郁 和中 、 化痰 、 解毒 ， 郁闷 心烦 、 肝胃气痛 、 梅核气 、 瘰疬 疮 毒
白花蛇舌草		清热解毒 、 利湿 散瘀 ， 肺 热 喘咳 等
水牛角		清热解毒 、 凉血 、 定 惊 ， 温病 高 热 、 神昏谵语 、 发 斑 发 疹 、 吐血 衄血 、 惊风 、 癫狂
马蔺		清热解毒 、 祛湿 除 痹 、 止血 利尿 、 通淋 杀 虫
鱼腥草		清热解毒 、 消痈 排 肿 、 利尿 通淋 ， 肺痈 吐 脓 、 痰 热 喘咳 、 热痢 、 热淋 、 痈肿 疮 毒
银柴胡		清虚热 、 除 疳 热 ， 阴虚发热 、 骨蒸 劳热 、 小儿 疳 热
制何首乌		补肝肾 、 益 精血 、 乌 须发 、 强 筋骨 ， 血虚 萎黄 、 眩晕耳鸣 、 须发 早 白 、 腰膝酸软 、 肢体麻木 、 崩漏 带下 、 久疟 体 虚 、 高 血脂
红参		大 补 元气 、 复 脉 固 脱 、 益气摄血 ， 体 虚 欲 脱 、 肢 冷脉微 、 气不摄血 、 崩漏 下血 、 心力衰竭 、 心 原 性 休克
荔枝核		行气散结 、 祛寒 止痛 ， 寒疝 腹痛 、 睾丸 肿 痛
木耳		补气 、 凉血止血 、 润肠通便
乌梢蛇		祛风 、 通络 、 止 痉 ， 风湿 顽痹 、 麻木 拘挛 、 中 风口 眼 喎 斜
珍珠母		平肝潜阳 、 定 惊 明目 ， 头痛 眩晕 、 烦燥 失眠 、 肝热 目赤 、 肝虚 目昏
泽漆		利水 消肿 、 消痰 、 杀 虫 、 清热解毒 ， 水气 、 肿满 等
莲子心		清心安神 、 交通心肾 、 涩 精 止血 ， 热入心包 、 神昏谵语 、 心肾不交 、 失眠 遗精 、 血热 吐血
龟甲		滋阴潜阳 、 益肾 强 骨 、 养血 补心 ， 阴虚潮 热 、 骨蒸 盗汗 、 头晕目眩 、 虚风内动 、 筋骨 痿 软 、 心虚 健忘
海风藤		祛 风湿 、 通 经络 、 止 痹 痛 ， 风寒湿痹 、 肢体疼痛 、 筋脉 拘挛 、 屈伸 不 利
紫草茸		清热解毒 、 凉血 活血 、 祛湿 杀 虫 、 凉血解毒 ， 麻疹 、 斑疹 不易 透 发 等
黄药子		凉血 降火 、 消 瘿 解毒
花蕊石		化瘀止血 ， 咯血 ， 吐血 ， 外伤 出血 ， 跌 扑 伤痛
透骨草		祛风 、 除湿 舒筋 、 活血 、 止痛 、 解 毒化 疹 ， 风湿痹 痛 等
韭菜		温中 、 行气 、 散 血 、 解毒
凌霄花		凉血 、 化瘀 、 祛风 ， 月经不调 、 经闭 癥瘕 、 产 后 乳肿 、 风疹 发 红 、 皮肤瘙痒 、 痤疮
苏合香		开窍 、 辟 秽 、 止痛 ， 中风痰厥 、 猝然 昏倒 、 胸 腹冷痛 、 惊痫
芒硝		泻热 通便 、 润燥 软坚 、 清 火 消肿 ， 实热 便秘 、 大便燥结 、 积滞 腹痛 、 肠 痈肿 痛 ， 外治 乳痈 、 痔疮 肿 痛
鸡冠花		收敛止血 、 止带 、 止 痢 ， 吐血 、 崩漏 、 便血 、 痔 血 、 赤白带下 、 久痢 不止
制川乌		祛风除湿 、 温经止痛 、 麻醉 止痛 ， 风寒湿痹 、 关节疼痛 ， 心腹 冷 痛 、 寒疝 作 痛 、 麻醉 止痛
蜘蛛		为 圆蛛 科 动物 大腹 圆蛛 的 全体 ， 有毒 。
荞麦		开胃 宽肠 、 下气 消积 、 解毒 疗 疮 ， 绞肠痧 、 肠胃 积滞 等
茶叶		清利头目 、 除 烦 止渴 、 利尿 、 清热解毒 、 下气 消食 、 化痰 ， 心烦 口渴 等
猪胆汁		益 肺 、 补脾 、 润燥 ， 消渴 、 便秘 、 黄疸 等
藤黄		消肿 、 化 毒 、 止血 、 杀 虫 ， 痈疽肿毒 等
桂皮		暖 脾胃 、 散 风寒 、 通 血脉 ， 腹 冷 胸满 、 呕吐 噎膈 、 风湿痹 痛 等
刺猬皮		降气 定 痛 、 凉血止血 ， 反胃 吐 食 、 腹痛 疝气 、 肠风 痔漏 、 遗精 等
核桃仁		补肾 、 温肺 、 润 肠 ， 腰膝酸软 、 阳痿 遗精 、 虚 寒喘 嗽 、 大便秘结
蚕砂		祛风除湿 、 活血 定 痛 ， 风湿痹 痛 、 风疹 瘙 痒 、 头 风头痛 等
马鞭草		活血散瘀 、 截疟 、 解毒 、 利水 消肿 ， 癥瘕 积聚 、 经闭 痛经 、 疟疾 、 喉痹 、 水肿 、 热淋
西瓜		清热解暑 、 除 烦 止渴 、 利小便 ， 暑热 烦渴 等
山慈菇		清热解毒 、 化痰散结 ， 痈肿 疔毒 、 瘰疬 痰核 、 淋巴结 结核 、 蛇 虫 咬 伤
八角茴香		温阳散寒 、 理气止痛 ， 寒疝 腹痛 、 肾虚腰痛 、 胃寒呕吐 、 脘 腹冷痛
仙鹤草		收敛止血 、 截疟 、 止 痢 、 解毒 ， 咯血 、 吐血 、 崩漏 下血 、 疟疾 、 血痢 、 脱 力 劳伤 、 痈肿 疮 毒 、 阴痒 带下
韭菜子		温 补肝肾 、 壮阳 固精 ， 阳萎 遗精 、 腰膝酸痛 、 遗尿 尿频 、 白浊 带下
柿蒂		降逆 下气 ， 呃逆
墨旱莲		滋补肝肾 、 凉血止血 ， 牙齿松动 、 须发 早 白 、 眩晕耳鸣 、 腰膝酸软 、 阴虚 血热 、 吐血 、 衄血 、 尿血 、 血痢 、 崩漏 下血 、 外伤 出血
片姜黄		破血 行气 、 通经止痛 的 作用 ； 血滞经闭 、 行经 腹痛 、 胸胁 刺 痛 、 风湿痹 痛 、 肩 臂 疼痛 、 跌 扑 损伤
西洋参		补气 养阴 、 清热生津 ， 气虚 阴 亏 、 内热 、 咳喘 、 虚热 烦 倦 、 口燥咽干
玳瑁		清热 、 解毒 、 镇 惊
急性子		破血 软坚 、 消积 ， 癥瘕 痞块 、 经闭 、 噎膈
红粉		拔毒 、 除 脓 、 去 腐 、 生 肌
闹羊花		驱 风 除湿 、 散瘀 定 痛 ， 风湿痹 痛 、 跌打损伤 、 皮肤 顽癣
火麻仁		润肠通便 ， 血虚津亏 、 肠燥便秘
黑芝麻		补肝肾 、 益 精血 、 润 肠 燥 ， 头晕眼花 、 耳鸣耳聋 、 须发 早 白 、 病 后 脱发 、 肠燥便秘
水红花子		散 血 消 癥 、 消积 止痛 ， 癥瘕 痞块 、 瘿瘤 肿 痛 、 食积 不消 、 胃脘 胀 痛
大蓟		散 血 消 癥 、 消积 止痛 ， 癥瘕 痞块 、 瘿瘤 肿 痛 、 食积 不消 、 胃脘 胀 痛
合欢皮		解郁安神 、 活血 消肿 ， 心神不安 、 忧郁 失眠 、 肺 痈疮 肿 、 跌 扑 伤痛
徐长卿		祛 风化 湿 、 止痒 止痛 ， 风湿痹 痛 、 胃痛 胀 满 、 牙痛 、 腰痛 、 跌 扑 损伤 、 荨麻疹 、 湿疹
化橘红		散 寒 、 燥湿 、 利气 、 消痰 ， 风寒咳嗽 、 喉痒 痰 多 、 食积 伤酒 、 呕 恶 痞 闷
路路通		祛风 活络 、 利水通 经 ， 关节 痹 痛 、 麻木 拘挛 、 水 肿胀 满 、 乳少 经闭
重楼		清热解毒 、 消肿止痛 、 凉肝 定 惊 ， 疔疮 痈肿 、 咽喉肿痛 、 毒蛇咬伤 、 跌 扑 伤痛 、 惊风 抽搐
沙苑子		温 补肝肾 、 固精 、 缩 尿 、 明目 ， 肾虚腰痛 、 遗精 早泄 、 白浊带 下 、 小便余沥 、 眩晕 目昏
天仙藤		行气活血 、 利水 消肿 ， 脘 腹 刺 痛 、 关节 痹 痛 、 妊娠水肿
制草乌		祛风除湿 、 温经止痛 ， 风寒湿痹 、 关节疼痛 、 心腹 冷 痛 、 寒疝 作 痛 、 麻醉 止痛
香橼		舒肝理气 、 宽中 、 化痰 ， 肝胃气滞 、 胸胁 胀 痛 、 脘腹痞满 、 呕吐 噫气 、 痰 多 咳嗽
滑石粉		利尿 通淋 、 清热解毒 、 祛湿 敛 疮 ， 热淋 、 石淋 、 尿 热 涩 痛 、 暑热 烦渴 、 湿 热水 泻 ， 外治 湿疹 、 湿 疮 、 痱子
浮小麦		止汗 、 退 热 除 烦
南沙参		养阴清肺 、 化痰 、 益气 ， 肺 热 燥 咳 、 阴虚劳 嗽 、 干咳 痰 粘 、 气 阴不足 、 烦热 口干
天仙子		解痉 止痛 、 安神 定喘 ， 胃 痉挛 疼痛 、 喘咳 、 癫狂
芥子		温肺 豁痰 利气 、 散结 通络止痛 ， 寒 痰喘 咳 、 胸胁 胀 痛 、 痰 滞 经络 、 关节 麻木 、 疼痛 、 痰湿流注 、 阻 疽 肿毒
瓦楞子		消痰 化瘀 、 软坚散结 、 制酸止痛 ， 顽 痰积 结 、 黏 稠 难 咯 、 瘿瘤 、 瘰疬 、 癥瘕 痞块 、 胃痛 泛 酸
灵芝		药材 为 多孔菌科 真菌灵芝 、 紫芝 的 干燥 子 实体 ， 具 补气 安神 、 止咳平喘 ， 眩晕 不 眠 、 心悸 气 短 、 虚劳 咳喘 。
葡萄		补 气血 、 强 筋骨 、 利小便 ， 气血 虚弱 、 肺虚 咳嗽 、 心悸 盗汗 等
耳草		清热解毒
山柰		行 气温 中 、 消食 、 止痛 ， 胸 膈 胀 满 、 脘 腹冷痛 、 饮食 不 消
黄皮		行气止痛 、 消肿 利水 、 除 积 止痛 、 理气化痰 ， 黄疸 、 疟疾 等
土贝母		散结 、 消肿 、 解毒 ， 乳痈 、 瘰疬 、 乳腺炎 、 颈 淋巴结 结核 、 慢性淋巴结炎 、 肥厚 性 鼻炎
血余炭		止血 、 化瘀 ， 吐血 、 衄血 、 尿血 、 崩漏 下血 、 外伤 出血
羊蹄		凉血止血 、 清热 通便 、 利水 、 杀 虫 ， 大便燥结 、 淋浊 、 黄疸
佩兰		芳香 化湿 、 醒脾开胃 、 发表 解暑 ， 湿浊 中 阻 、 脘痞 呕 恶 、 口中 甜 腻 、 口臭 、 多涎 、 暑湿 表证 、 头胀 胸闷
岗梅		清热 、 生津 、 活血 、 解毒 ， 感冒 等
菝葜		祛风 利湿 、 解毒 散瘀 ， 筋骨 酸痛 、 小便 淋漓 、 带下 量 多 、 疔疮 痈肿
榧子		杀 虫 消积 、 润燥通便 ， 钩虫 、 蛔虫 、 绦虫 、 虫积腹痛 、 小儿疳积 、 大便秘结
鹅不食草		通鼻 窍 、 止咳 ， 风寒头痛 、 咳嗽痰多 、 鼻塞 不 通 、 鼻渊 流 涕
紫苏梗		理气 宽中 、 止痛 、 安胎 ， 胸膈痞闷 、 胃脘 疼痛 、 嗳气 呕吐 、 胎动不安
红豆蔻		燥湿 散 寒 、 醒脾 消食 ， 脘 腹冷痛 、 食积 胀 满 、 呕吐泄泻 、 饮酒 过 多
半枝莲		清热解毒 、 化瘀 利尿 ， 疔疮 肿毒 、 咽喉肿痛 、 毒蛇咬伤 、 跌 扑 伤痛 、 水肿 、 黄疸
千年健		祛 风湿 、 壮 筋骨 ， 风寒湿痹 、 腰 膝 冷 痛 、 下肢 拘挛 麻木
饴糖		补气 、 补虚 生津 、 润燥 ， 里急 腹痛 、 肺燥咳嗽 等
刺五加		益气健脾 、 补肾安神 ， 脾肾阳虚 、 体 虚 乏力 、 食欲不振 、 腰膝酸痛 、 失眠多梦
丝瓜络		通络 、 活血 、 祛风 ， 痹 痛 拘挛 、 胸胁 胀 痛 、 乳汁不通
马蔺子		清热利湿 、 解毒消肿 、 凉血止血 、 祛湿 通痹 、 健脾和胃
紫檀		消肿 、 止血 、 定 痛 ， 肿毒 、 金疮 出血
蛤壳		清热化痰 、 软坚散结 、 制酸止痛 ， 痰 火 咳嗽 、 胸胁 疼痛 、 痰中带血 、 瘰疬 瘿瘤 、 胃痛 吞酸 ， 外治 湿疹 、 烫伤
椿皮		清热燥湿 、 收涩 止带 、 止泻 、 止血 ； 赤白带下 、 湿热 泻痢 、 久泻 久痢 、 便血 、 崩漏
瓜蒌皮		清化热痰 、 利气 宽胸 ， 痰 热 咳嗽 、 胸闷 胁痛
黄瓜		清热解毒 、 利水 消肿 ， 咽喉肿痛 等
橄榄核		行气止痛 ， 诸 鱼 骨鲠 、 胃痛 、 疝气 等
穿心莲		清热解毒 、 凉血 、 消肿 ， 感冒 发热 、 咽喉肿痛 、 口舌生疮 、 顿咳 劳嗽 、 泄泻 痢疾 、 热淋 涩 痛 、 痈肿 疮疡 、 毒蛇咬伤
枫香脂		活血止痛 、 解毒 、 生 肌 、 凉血 ， 跌 扑 损伤 、 痈疽 肿 痛 、 吐血 、 衄血 、 外伤 出血
瓜蒌子		润肺化痰 、 滑肠通 便 ， 燥 咳 痰 黏 、 肠燥便秘
冬瓜皮		利水 消肿 ， 水 肿胀 满 、 小便不利 、 暑热 口渴 、 小便短赤
牡荆		解肌 发 汗 、 祛风 、 化痰 ， 感冒 等
伸筋草		祛风除湿 、 舒筋 活络 ， 关节 酸痛 、 屈伸 不 利
千金子		逐水 消肿 、 破血 消 症 ， 水肿 、 痰饮 、 积 滞胀 满 、 二 便 不 通 、 血瘀经闭 ， 外治 顽癣 、 疣 等
钟乳石		温肺 、 助阳 、 平喘 、 制 酸 、 通乳 ， 寒 痰喘 咳 、 阳虚 冷喘 、 腰 膝 冷 痛 、 胃痛 泛 酸 、 乳汁不通
莲房		化瘀止血 ， 崩漏 、 尿血 、 痔疮 出血 、 产 后 瘀 阻 、 恶露不尽
龙眼		补血
青风藤		祛 风湿 、 通 经络 、 利小便 ， 风湿痹 痛 、 关节肿胀 、 麻痹 瘙 痒
首乌藤		养血安神 、 祛风通络 ， 失眠多梦 、 血虚 身 痛 、 风湿痹 痛 ， 外治 皮肤瘙痒
石楠		祛风 、 活络 、 益肾 ， 肾阳虚 、 风痹 等
千里光		清热解毒 、 清肝 明目 、 祛风燥湿 、 杀 虫 ， 各种 急性炎 性 疾病 、 风 火 赤眼
关木通		清心 火 、 利小便 、 通经 下乳 ， 口舌生疮 、 湿热 痹证 等 ， 但 含有 马兜铃酸 可 引发 肾病
玫瑰花		行气解郁 、 和血 、 止痛 ， 肝胃气痛 、 食少 呕 恶 、 月经不调 、 跌 扑 伤痛
苎麻根		清热 、 止血 、 解毒 、 散瘀 ， 热病 大 渴 、 血淋 、 癃闭 等
香加皮		祛 风湿 、 强 筋骨 ， 风寒湿痹 、 腰膝酸软 、 心悸 气 短 、 下肢 浮肿
莴苣		活血祛瘀 、 泻热 利水 、 杀 虫 蛇毒 ， 小便不利 、 尿血 等
苦楝皮		驱虫 、 疗 癣 ， 蛔 蛲虫病 、 虫积腹痛 ， 外治 疥癣 瘙 痒
蕲蛇		祛风 、 通络 、 止 痉 ， 风湿 顽痹 、 麻木 拘挛 、 中 风口 眼 ? 斜 、 半身不遂 、 抽搐 痉挛 、 破伤风 、 麻风 疥癣
橄榄		清肺 、 利咽 、 生津 、 解毒 ， 咽喉肿痛 、 咳嗽 、 烦渴 、 鱼 蟹 中毒
升药		搜 脓 拔毒 、 祛腐生肌
天葵		清热解毒 、 利水 ， 瘰疬 、 疝气 等
冬虫夏草		补肺 益肾 、 止血 、 化痰 ， 久咳 虚喘 、 劳嗽 咯血 、 阳痿 遗精 、 腰膝酸痛
辣椒		温中散寒 、 开胃消食 、 活血化瘀 、 益气 消肿 ， 寒 滞 腹痛 、 冻疮 、 疥癣
凤凰衣		养阴 、 清肺 ， 久咳 、 咽 痛失 音 、 瘰疬 结核 等
老鹳草		祛 风湿 、 通 经络 、 止 泻痢 ， 风湿痹 痛 、 麻木 拘挛 、 筋骨 酸痛 、 泄泻 痢疾
蝼蛄		利水 、 通便
桉油		为 祛风止痛 ， 皮肤瘙痒 、 神经痛
蜥蜴		消瘿散 瘰
半边莲		利尿 消肿 、 清热解毒 ， 大腹水肿 、 面 足 浮肿 、 痈肿 疔疮 、 蛇 虫 咬 伤 、 晚期 血吸虫病 腹水
西河柳		散风 、 解表 、 透疹 ， 麻疹 不 透 、 风湿痹 痛
女贞		行气活血 、 强 筋 壮 骨 、 祛风明目 、 解毒消肿 ， 胁痛 、 闭经 、 肾虚腰痛 等
山芝麻		解表清 热 、 消肿 解毒 ， 感冒 发热 、 头痛
金果榄		清热解毒 、 利咽 、 止痛 ， 咽喉肿痛 、 痈疽 疔毒 、 泄泻 、 痢疾 、 脘 腹 热 痛
瓦松		止血 、 解毒 、 敛 疮 ， 血痢 、 便血 、 疮口 久 不 愈 合
龙葵		清热解毒 、 活血 消肿 ， 疔疮 、 痈肿 、 丹毒
川木通		清热 利尿 、 通经 下乳 ， 水肿 、 淋病 、 小便不通 、 关节 痹 痛 、 经闭 乳少
豹骨		追 风 定 痛 、 强筋健骨 ， 筋骨疼痛 、 风寒湿痹 、 四肢拘挛 、 麻木 、 腰 膝 酸楚
拳参		清热解毒 、 消肿 、 止血 ， 赤痢 、 热泻 、 肺热咳嗽 、 痈肿 、 瘰疬 、 口舌生疮 、 吐血 、 衄血 、 痔疮 出血 、 毒蛇咬伤
九节菖蒲		开窍豁痰 、 祛风 宣 湿 、 健胃 解毒 ， 热病 神昏谵语 、 癫痫 痰厥
金沸草		降气 、 消痰 、 行水 ， 风寒咳嗽 、 痰饮 蓄 结 、 痰 壅 气逆 、 胸 膈 痞满 、 喘咳 痰 多 ， 外治 疔疮 肿毒
凤仙花		祛 风湿 、 活血 、 通经
凤尾草		清热利湿 、 凉血止血 、 消肿 解毒 ， 黄疸型肝炎 、 肠炎 等
豌豆		和 中下 气 、 利小便 、 解 疮 毒 ， 霍乱 、 脚气 、 痈肿
地枫皮		祛风除湿 、 行气止痛 ， 风湿痹 痛 、 腰肌劳损
李子		清热 、 生津 ， 虚 劳骨蒸 、 消渴 、 腹水 等
九香虫		理气止痛 、 温中 助阳 ， 胃 寒胀 痛 、 肝胃气痛 、 肾虚 阳痿 、 腰膝酸痛
罂粟		涩肠固脱 、 行气止痛 ， 反胃 、 腹痛 等
西红花		活血化瘀 、 凉血解毒 、 解郁安神 ， 临床 经闭 癥瘕 、 产 后 瘀 阻 、 温毒发斑 、 忧郁 痞 闷 、 惊悸 发狂
红大戟		泻 水 逐 饮 、 攻 毒 消肿散结 ， 胸 腹 积水 、 二 便 不利 、 痈肿 疮 毒 、 瘰疬 痰 核
络石藤		祛风通络 、 凉血 消肿 ， 风湿热 痹 、 筋脉 拘挛 、 腰膝酸痛 、 喉痹 、 痈肿 、 跌 扑 损伤
木蝴蝶		清肺 利咽 、 疏肝和胃 ， 临床 肺热咳嗽 、 喉痹 、 音 哑 、 肝胃气痛
合欢花		解郁安神 ， 心神不安 、 忧郁 失眠
海狗肾		暖 肾 壮阳 、 益 精 补 髓 ， 虚损 劳伤 、 阳痿 精 衰 、 腰 膝 痿 弱 等
辣蓼		祛 风湿 、 活血祛瘀
稻芽		和中 消食 、 健脾 开胃 ， 食积 不消 、 腹胀 口臭 、 脾胃虚弱 、 不 饥 食少
地锦草		清热解毒 、 活血 止血 ， 痢疾 、 泄泻 、 咯血 、 尿血 、 便血 、 崩漏 、 疮 疖 痈肿
芫荽		发汗解表 、 宣 透 麻疹 、 消食 下气 ， 麻疹 透 发 不利 、 食物 积滞
雷公藤		祛 风湿 、 消炎 解毒 ， 风湿性关节炎
五加		活血祛瘀 、 祛 风湿
莳萝		温脾 开胃
浮海石		化痰
矮地茶		化痰止咳 、 利湿 、 活血 ， 新 久咳嗽 、 痰中带血 、 湿热 黄疸 、 跌打损伤
黑大豆		活血 、 利水 、 祛风 、 解毒 、 明目 退翳 ， 水 肿胀 满 等
花生		润肺 、 和胃 ， 燥 咳 等
冬葵		祛湿 利水 、 润下
穿山龙		祛 风湿 、 止痛 、 舒筋 活血 、 止咳平喘 祛痰 ， 风湿性关节炎 、 腰 腿 疼痛 、 麻木 ， 大骨节病 、 跌 扑 损伤 、 闪腰岔气 、 慢性支气管炎 、 咳嗽气喘
郁李		降气 、 止咳平喘
甜瓜		生津止渴 、 清 暑热 、 解 烦渴 、 利小便 ， 消渴 等
蜂蜡		收涩 、 敛 疮 、 生 肌 、 止痛 ， 溃 汤 不 敛 、 臁疮 糜烂 、 创伤 、 烧 烫伤
鹿衔草		祛 风湿 、 强 筋骨 、 止血 ， 风湿痹 痛 、 腰 膝 无力 、 月经过多 、 久咳 劳嗽
土木香		健脾和胃 、 调气 解郁 、 止痛 安胎 ， 胸胁 、 脘 腹胀 痛 、 呕吐 泻痢 、 胸胁 挫伤 、 岔气 作 痛 、 胎动不安
罗勒		疏 风行 气 、 化湿 消食 、 活血 、 解毒 ， 外感头痛 等
十大功劳		清热泻火 、 凉血解毒 ， 流感 、 热痢 、 腹泻 等
余甘子		清热凉血 、 消食健胃 、 生津 止咳 ， 血 热血 瘀 、 消化不良 、 腹胀 、 咳嗽 、 喉痛 、 口干 ， 多 入 丸 散 服
垂盆草		清利湿热 、 解毒 ， 湿热 黄疸 、 小便不利 、 痈肿 疮疡 、 急 慢性肝炎
地胆草		清热解毒 、 利尿 消肿 ， 感冒 、 急性扁桃体炎 、 咽喉炎 、 眼 结膜炎 、 流行性乙型脑炎 等 病症
槲寄生		祛 风湿 、 补肝肾 、 强 筋骨 、 安胎 ， 风湿痹 痛 、 腰膝酸软 、 胎动不安
广金钱草		清热除湿 、 利尿 通淋 ， 热淋 、 砂淋 、 石淋 、 小便涩痛 、 水肿 尿 少 、 黄疸 尿 赤 、 尿路结石
洋金花		平喘 止咳 、 镇痛 、 解痉 ， 哮喘 咳嗽 、 脘 腹冷痛 、 风湿痹 痛 、 小儿 慢 惊 、 外科 麻醉
玉米须		利尿 、 泄 热 、 平肝 、 利 胆 ， 肾炎水肿 、 脚气 、 黄疸 肝炎 等
寻骨风		祛风通络 ， 风湿 关节痛 等
鸦胆子		清热解毒 、 截疟 、 止 痢 、 腐蚀 赘疣 ， 痢疾 、 疟疾 ， 外治 赘疣 、 鸡眼
望月砂		明目 、 杀 虫 ， 目 暗 生 翳 、 疳疾 、 痔 瘘
满山红		止咳 、 祛痰 ， 慢性支气管炎
三叉苦		清热解毒
千金子霜		逐水 消肿 、 破血 消 症 ， 水肿 、 痰饮 、 积 滞胀 满 、 二 便 不 通 、 血瘀经闭 ， 外治 顽癣 、 疣 等
棕榈炭		收涩止血 ， 吐血 、 衄血 、 尿血 、 便血 、 崩漏 下血
丁公藤		祛风除湿 、 消肿止痛 ， 风湿痹 痛 、 半身不遂 、 跌 打 肿 痛
朱砂七		止血 、 清热解毒 ， 痈肿 、 外伤 出血 等
预知子		舒肝理气 、 活血止痛 、 利尿 、 杀 虫 ， 脘 胁 胀 痛 、 经闭 痛经 、 小便不利 、 蛇 虫 咬 伤
灶心土		温中 燥湿 、 和胃 止 呕 、 温脾 涩 肠 、 止血 ， 呕吐 反胃 、 腹痛 泄泻 、 出血 等
积雪草		清热利湿 、 解毒消肿 ， 湿热 黄疸 、 中暑 腹泻 、 砂淋 血淋 、 痈肿 疮 毒 、 跌 扑 损伤
灯心草		清心 火 、 利小便 ， 心烦 失眠 、 尿 少 涩 痛 、 口舌生疮
芜菁		利湿 解毒 、 降气 宽中 、 平喘 止咳 、 养肝明目 、 破 积 通淋 ， 食积 不 化 、 黄疸 、 消渴 等
六月雪		祛风 利湿 、 清热解毒 ， 风湿 腰腿痛 、 痢疾 、 水肿 等
土荆皮		杀虫止痒 ， 疥癣
火炭母		清热利湿 、 凉血解毒 ， 泄泻 、 痢疾 、 黄疸 、 风热 咽痛 等
人参芦		涌吐 、 升阳 ， 虚人 痰 壅 阻 膈 、 气陷泄泻 等
平贝母		清热 润肺 、 化痰止咳 ， 肺 热 燥 咳 、 干咳少痰 、 阴虚劳 嗽 、 咳 痰 带 血
紫珠		活血 止血 、 除 热 解毒 ， 吐血 、 咯血 等
龟甲胶		为 龟科 动物 的 龟甲 经 煎 煮 、 浓缩 制成 的 固体 胶 ， 有 滋阴 、 养血 、 止血 ， 阴虚潮 热 、 骨蒸 盗汗 、 腰膝酸软 ， 血虚 萎黄 、 崩漏 带下 。
石楠藤		祛 风湿
臭梧桐		祛风除湿 、 消积 导 滞 、 疗 疳 除 疾 、 截疟 、 消肿散瘀 、 解毒 疗 疮 ， 风湿痹 痛 等
胖大海		清热 润肺 、 利咽解毒 、 润肠通便 ， 肺 热 声哑 、 干咳 无 痰 、 咽喉 干 痛 、 热结 便闭 、 头痛目赤
鼠妇		破血 、 利 水解 毒 、 止痛
穿破石		祛风 利湿 、 活血通经 ， 风湿 关节疼痛 、 黄疸 等
毛冬青		清热解毒 、 活血通络 、 利水渗湿 ， 肺 热 咳喘 等
石见穿		活血化瘀 、 清热利湿 、 散结 消肿 ， 月经不调 等
麦饭石		解毒 排 脓
绿萼梅		疏肝解郁 作用 ， 胸胁苦满 、 肝气郁结 、 月经不调 等
紫贝齿		清热 、 平肝 安神 、 明目
海参		补肾益精 、 养血润燥
明党参		润肺化痰 、 养阴和胃 、 平肝 、 解毒 ， 肺热咳嗽 、 呕吐 反胃 、 食少 口干 、 目赤 眩晕 、 疔毒 疮疡
五指毛桃		健脾 补肺 、 行气 利湿 、 化痰 ， 肺痨 咳嗽 、 盗汗 等
杜仲叶		补肝肾 、 强 筋骨 ， 肝 肾 不足 、 头晕目眩 、 腰膝酸痛 、 筋骨 痿 软
金礞石		坠 痰 下气 、 平肝 镇 惊 ， 顽痰 胶 结 、 咳逆 喘急 、 癫痫 发狂 、 烦躁 胸闷 、 惊风 抽搐
蝮蛇		祛风 、 攻 毒
广枣		行气活血 、 养心 ， 安神 ， 气滞血瘀 、 胸痹 作 痛 ， 心悸 气 短 ， 心神不安
海龙		补肾壮阳 、 散结 消肿 ， 阳痿 遗精 、 癥瘕 积聚 、 瘰疬 痰核 、 跌 扑 损伤 ， 外治 痈肿 疔疮
黄狗肾		补益 ， 虚证
万年青		强心利 尿 、 清热解毒 、 止血
焦槟榔		消食导滞 ， 食积 不消 、 泻痢 后重
北豆根		清热解毒 、 祛风止痛 ， 咽喉肿痛 、 肠炎 痢疾 、 风湿痹 痛
水杨梅		清热解毒 、 止血 ， 高热 泻痢 、 外伤 出血 等
葫芦茶		清热解毒 、 利湿 消 滞 、 杀 虫 ， 感冒 等
苦瓜		清暑 涤 热 、 明目 解毒 、 清热 止 痢 、 降气 止痛 ， 热病 烦渴 等
刀豆		温中 、 下气 、 止 呃 ， 临床 虚寒 呃逆 、 呕吐
救必应		清热解毒 、 清热燥湿 、 消肿止痛 ， 感冒 发热 等
一枝黄花		疏风清热 、 消肿 解毒 ， 感冒头痛 、 咽喉肿痛 、 黄疸
川木香		行气止痛 ， 临床 脘 腹胀 痛 、 肠鸣 腹泻 、 里急后重 、 两 胁 不 舒 、 肝胆 疼痛
苎麻		清热 、 止血
厚朴花		理气 ， 化湿 ， 胸脘痞闷 胀 满 、 纳谷 不 香
青葙		燥湿 清热 、 杀 虫 、 止血 、 明目 去 翳 ， 风 瘙 身痒 、 疮 疥 等
绞股蓝		消炎 解毒 、 止咳祛痰 ， 慢性气管炎
大血藤		清热解毒 、 活血 ， 祛风 ， 临床 肠痈腹痛 、 经闭 痛经 、 风湿痹 痛 、 跌 扑 肿 痛
荔枝草		凉血止血 、 利水 消肿 、 解 毒杀 虫 ， 咳血 等
臭牡丹		消肿 解毒 、 祛风除湿 、 健脾 除 疳 、 养血平肝 、 消 痔 提 肛 ， 痈疽 等
南板蓝根		清热解毒 、 凉血 ， 温病 发 斑 、 丹毒 、 流感 、 流脑
番泻叶		泻热 行滞 ， 通便 ， 利水 ， 热结 积滞 ， 便秘 腹痛 ， 水 肿胀 满
雪上一枝蒿		消炎 止痛 、 祛风除湿 ， 跌打损伤 等
黄栌		清热解毒 、 清利湿热 ， 黄疸 、 漆疮 、 皮肤瘙痒 症
白英		清热燥湿 、 祛风止痛 、 活血祛瘀 ， 风 火牙痛 、 头痛 等
蚕豆		健脾 、 利湿 ， 膈 食 、 水肿 、 小便不利
毛诃子		清热解毒 、 收敛 养血 、 调和 诸 药 ， 各种 热证 、 泻痢 、 黄 水病 、 肝胆病 、 病 后 虚弱
了哥王		清热解毒 、 消肿散结 、 止痛 ， 瘰疬 、 痈肿 、 风湿痛 等
云芝		免疫调节 作用 ， 治疗 慢性肝炎 、 活动性肝炎
银耳		滋补 生津 、 润肺 养胃
功劳木		清热燥湿 、 泻火解毒 ， 湿热 泻痢 、 黄疸 、 目赤 肿 痛 、 胃火牙痛 、 疮 疖 、 痈肿 、 痢疾 、 黄疸型肝炎
鸡骨草		清热解毒 、 疏肝 止痛 ， 黄疸 、 胁 肋 不 舒 、 胃脘 胀 痛 、 急 慢性肝炎 、 乳腺炎
守宫		祛风 、 定 惊 散结 、 解毒
枇杷		润肺 、 止渴 、 下气 ， 肺痿 咳嗽 吐血 、 衄血 等
铁苋菜		清热 、 利水 、 杀 虫 、 凉血止血 ， 痢疾 等
木槿		清热 止 痢 、 解毒 疗 疮 、 清肺止咳 、 凉肝 熄风 、 燥湿 止痒 ， 疔疮 疖 肿 等
天名精		祛痰 、 清热 、 破血 、 止血 、 解毒 、 杀 虫 ， 乳蛾 、 喉痹 等
猫爪草		散结 、 消肿 ， 瘰疬 未 溃 ， 淋巴结 结核
鲜地黄		清热生津 、 凉血 、 止血 ， 热病 伤 阻 、 舌绛 烦渴 、 发 斑 发 疹 、 吐血 、 衄血 、 咽喉肿痛
土荆芥		祛风 、 杀 虫 、 通经 、 止痛 ， 风湿痹 痛 、 虫证 等
罗汉果		清热 润肺 、 滑肠通 便 ， 肺火 燥 咳 、 咽 痛失 音 、 肠燥便秘
鸭跖草		清热解毒 、 利水 消肿 ； 治疗 风热感冒 、 高热 不 退 、 咽喉肿痛 、 水肿 尿 少 、 热淋 涩 痛 、 痈肿 疔毒
七叶莲		祛风除湿 、 活血止痛 ， 风湿痹 痛 、 胃痛 等
九里香		行气止痛 、 活血散瘀 ， 胃痛 、 风湿痹 痛 ， 外治 牙痛 、 跌 扑 肿 痛 、 虫 蛇咬伤
四季青		清热解毒 、 生 肌 敛 疮 、 活血 止血 ， 肺热咳嗽 等
蘑菇		安神 、 开胃 、 止泻 、 止吐 ， 腹泻 等
枸橘		疏肝理气 、 行气止痛 、 祛风止痒 、 解 酒 毒 、 消肿 止 呕 ， 胸 腹胀 满 、 胃痛 等
八月札		舒肝理气 、 活血止痛 、 除 烦 利尿 ， 肝胃气痛 、 胃热 食 呆 、 烦渴 、 赤白痢 疾 、 腰痛 、 胁痛 、 疝气 、 痛经 、 子宫 下坠
列当		补肾壮阳 、 强 筋 、 止泻 ， 肾虚 腰 膝 冷痛 等
一点红		清热解毒
天葵子		清热解毒 、 消肿散结 ， 痈肿 疔疮 、 乳痈 、 瘰疬 、 毒蛇咬伤
咖啡		理气 作用
苦木		清热 、 祛湿 、 解毒 ， 风热感冒 、 咽喉肿痛 、 腹泻 下 痢 、 湿疹 、 疮 疖 、 毒蛇咬伤
月季花		活血调经 ， 月经不调 、 痛经
蓼大青叶		清热解毒 、 凉血 消 斑 ， 温病 发热 、 发 斑 发 疹 、 肺 热 喘咳 、 喉痹 、 痄腮 、 丹毒 、 痈肿
广防己		祛风止痛 、 清热 利水 ， 湿 热身 痛 等
松花粉		燥湿 、 收敛止血 ， 湿疹 、 黄水疮 、 皮肤 糜烂 、 脓 水淋沥 、 外伤 出血 、 尿布性皮炎
罗布麻叶		平肝 安神 、 清热 利水 ， 肝阳眩晕 、 心悸失眠 、 浮肿 尿 少 、 高血压 、 神经衰弱 、 肾炎水肿
肿节风		清热凉血 、 活血 消 斑 、 祛风通络 ， 血热 紫斑 、 紫癜 、 风湿痹 痛 、 跌打损伤
胡颓子		收敛 止 遗 、 止咳平喘 、 健脾 消积 、 清热利咽 ， 泻痢 等
鹧鸪菜		杀 虫 ， 蛔虫病 、 虫 疳
鸡矢藤		祛风 活血 、 止痛 解毒 、 消食导滞 ， 风湿 疼痛 、 腹泻 痢疾 、 脘腹痛
人参叶		补气 、 益 肺 、 祛暑 、 生津 ， 气虚咳嗽 、 虚热 烦躁 、 津 伤 口渴 、 头目 不 清 、 四肢倦乏
连钱草		利湿 通淋 、 清热解毒 、 散瘀 消肿 ， 热淋 、 石淋 、 湿热 黄疸 、 疮 痈肿 痛 、 跌 扑 损伤
砒石		截疟 、 杀 虫 ， 内服 具有 解毒
铁包金		化瘀止血 、 祛风胜湿 、 消肿 解毒 ， 肺痨 久咳 、 风湿 疼痛 等
三分三		麻醉 镇痛 ， 胃痛 、 骨折 、 风湿痛
苦地丁		清 热毒 、 消 痈肿 ， 临床 咽喉肿痛 、 疔疮 痛 肿 、 痈疽 发背 、 痄腮 丹毒
蜂胶		抗菌消炎 、 调节 免疫 、 抗 氧化 、 加速 组织 愈合 的 作用 ， 高脂血症 和 糖尿病 的 辅助 治疗
水飞蓟		清热解毒 、 舒肝 利 胆 ， 肝胆湿热 、 胁痛 、 黄疸
当药		清热 、 健胃 、 利湿 ， 消化不良 、 胃炎 、 黄疸 、 火眼 、 牙痛 、 口疮 等
沙棘		止咳祛痰 、 消食化滞 、 活血散瘀 ， 咳嗽痰多 、 消化不良 、 食积腹痛 、 瘀血 经闭 、 跌 扑 瘀 肿
银杏叶		敛肺 、 平喘 、 活血化瘀 、 止痛 ， 肺虚 咳喘 、 冠心病 、 心绞痛 、 高脂血症
仙人掌		行气活血 、 清热解毒 、 凉血止血 、 清肺止咳 ， 心 胃气痛 、 痞块 、 出血
苘麻		解毒 、 祛风 ， 关节 酸痛 等
红木香		行气 调 中 、 活血通络 、 止痛 ， 气滞 腹胀 痛 、 胃痛 等
南五味子		收敛 固涩 、 益气生津 、 补肾 宁 心 ， 久嗽 虚喘 、 梦遗 滑精 、 遗尿 尿频 、 久泻 不 止 、 自汗 、 盗汗 、 津 伤 口渴 、 短气 脉 虚 、 内热 消渴 、 心悸失眠
三棵针		清热解毒
板栗		益气健脾 、 补肾 强 筋 、 活血 消肿
三叶青		清热解毒 、 活血祛瘀
番石榴		涩肠止泻 、 解毒 止痛 ， 痢疾 、 腹泻 、 湿毒 等
木芙蓉叶		凉血 、 解毒 、 消肿 、 止痛 ， 痈疽 等
苘麻子		清热利湿 、 解毒 、 退翳 ， 赤白痢 疾 、 淋病 涩 痛 、 痈肿 、 目 翳
云实		清热除湿 、 杀 虫 、 行气止痛 、 截疟 、 止 消渴 ， 痢疾 等
野马追		清热解毒 、 祛痰 、 定喘 、 降 血压 ， 慢性气管炎 、 支气管炎 、 高血压 病
木棉		清热利湿 、 收敛止血 ， 慢性胃炎 、 胃溃疡出血 、 赤痢 、 瘰疬
地耳草		清热利湿 、 解毒消肿 、 散瘀 止痛 ， 传染性肝炎 、 泻痢 、 小儿惊风 等
白屈菜		镇痛 、 止咳 、 利尿 解毒 ， 胃肠 疼痛 、 黄疸 等
金莲花		清热解毒 ， 上呼吸道感染 、 扁桃体炎 等
金钱白花蛇		祛风 、 通络 、 止 痉 ， 风湿 顽痹 、 麻木 拘挛 、 中 风口 ? 、 半身不遂 、 抽搐 痉挛 、 破伤风 、 麻风 疥癣 、 瘰疬 恶疮
猕猴桃		清热解毒 、 利尿 通淋 、 健胃 和中 ， 烦热 、 消渴 等
萹蓄		利尿 通淋 、 杀 虫 、 止痒 ， 膀胱 热淋 、 小便短赤 、 淋沥 涩 痛 、 皮肤 湿疹 、 阴痒 带下
无花果		清热解毒 、 健胃 清肠 ， 肠炎 、 痢疾 、 便秘 等
紫花杜鹃		镇 咳 、 祛痰 ， 慢性气管炎
石花		养血 、 明目 、 补肾 、 利尿 、 清热 、 解毒
朱砂根		解毒消肿 、 活血止痛 、 祛风除湿 ， 咽喉肿痛 、 风湿痹 痛 、 跌打损伤
木芙蓉		清热燥湿 、 止咳化痰 ， 痈肿 等
溪黄草		清热利湿 、 凉血散瘀 ， 急性肝炎 等
南瓜		补中益气 、 消炎 止痛 、 解 毒杀 虫 ， 脚气 病 等
大头陈		驱 风 解表 、 清热燥湿 ， 感冒头痛 、 腹痛 泄泻 、 皮炎 等
雪莲花		温肾壮阳 、 温经散寒 、 祛寒化痰 、 祛风除湿 、 止血 ， 阳萎 等
过山龙		活血散瘀 、 解毒消肿 、 祛风 除 痹 、 生 肌 长骨 ， 跌打损伤 、 疮 痈肿 疖 、 痹症
海胆		软坚散结 、 化痰 消肿
菠菜		养血止血 、 敛阴 燥湿 、 疏散 风热 、 利 肺 润 肠 ， 便血 、 衄血 、 消渴 等
石吊兰		清肺 消痰 、 凉血止血 、 祛 湿化 滞 、 通络止痛 ， 肺热咳嗽 、 吐血 等
柠檬		生津止渴 、 祛暑 益气 、 下气 和胃 、 安胎 ， 胃痛 、 流产 等
翻白草		清热解毒 、 止血 消肿 ， 痢疾 、 疟疾 等
三白草		清热解毒 、 利尿 通淋 ， 小便不利 、 淋沥 涩 痛 、 白带 、 尿路感染 、 肾炎水肿 ， 外治 疮疡 肿毒 、 湿疹
山楂叶		活血化瘀 、 理气 通脉 ， 气滞血瘀 、 胸闷 憋气 、 心悸 健忘 、 眩晕耳鸣
黄藤		清热解毒 、 泻火通便 ， 热毒 内 盛 、 便秘 、 泻痢 、 咽喉肿痛 、 目 赤红 肿 、 痈肿 疮 毒
冬凌草		清热解毒
香茅		疏风解表 、 祛瘀 通脉
吉祥草		清肺止咳 、 止血 、 解毒
金荞麦		清热解毒 、 排 脓 祛瘀 ， 肺 脓 疡 、 麻疹 肺炎 、 扁桃体周围脓肿
买麻藤		祛风除湿 、 活血散瘀 、 止咳化痰 ， 跌打损伤 、 风湿骨痛 、 鹤膝风 等
墓头回		祛风 止 疟 、 祛瘀止血 ， 温疟 等
八角枫		疏风散寒 、 行气通络 ， 风湿 疼痛 等
华山参		平喘 止咳 、 安神 镇 惊 ， 寒 痰喘 咳 、 心悸失眠 易 惊
紫金龙		止痛 、 降压 、 止血 ， 各种 疼痛 、 高血压 、 跌打损伤 等
绵马贯众		清热解毒 、 驱虫 ； 虫积腹痛 、 疮疡
锦灯笼		清热解毒 、 利咽 、 化痰 、 利尿 ， 咽痛 音 哑 、 痰 热 咳嗽 、 小便不利 ， 外治 疱 疮 、 湿疹
夹竹桃		强心利 尿 、 祛痰 定喘 、 镇痛 、 散瘀 ， 喘息 咳嗽 、 癫痫 等
除虫菊		燥湿 灭 虫 、 除 蚊 灭 虫 ， 疥癣 ， 灭 蚊 、 蝇 、 跳蚤 、 虱 、 臭虫
木槿皮		清热利湿 、 杀虫止痒 、 清热解毒 ， 肠风下血 等
蚱蜢		安神 、 活血
天山雪莲		本 品系 维吾尔族 习用 药材 。 为 菊科 植物 天山雪莲 的 干燥 地上 部分 。 维吾尔 医 ： 补肾 活血 ， 强 筋骨 ， 营养神经 ， 调节异常 体液 ； 风湿性关节炎 、 关节疼痛 、 肺寒 咳嗽 、 肾 与 小腹 冷 痛 、 白带 过 多等 。 中医 ： 温肾助阳 ， 祛风胜湿 ， 通经 活血 ； 风寒湿痹 痛 、 类风湿性关节炎 、 小腹 冷 痛 、 月经不调 。
玉兰		清热
萆薢		利水 、 祛风 利湿
芒果		生津止 呕 、 利尿 、 行气 疏 滞 、 生津止渴 、 解毒 疗 疮 ， 口渴 、 呕吐 、 伤暑 等
朱砂莲		清 火 消肿 、 散 血 止痛 、 解 蛇毒 ， 红 白 痢疾 、 胸痛 等
漆姑草		清热解毒 、 排脓消肿 ， 漆疮 、 秃疮 、 痈肿 等
马钱		祛 风湿
鼠曲草		化痰 、 止咳 、 祛 风寒 ， 咳嗽痰多 、 气喘 等
小叶莲		调经活血 ， 血瘀经闭 、 难产 、 死胎 、 胎盘 不 下
西瓜皮		清热解暑 、 止渴 、 利小便 ， 暑热 烦渴 等
猫眼草		祛痰平喘 、 利水渗湿 ， 咳嗽 等
亚麻子		润燥 、 祛风 ， 肠燥便秘 、 皮肤 干燥 瘙 痒 、 毛发 枯萎 脱落
灯盏细辛		祛风散 寒 、 活血通络止痛 ， 风寒湿痹 痛 、 中风 瘫痪 、 胸痹 心痛 、 牙痛 、 感冒
人参果		强 心 补肾 、 生津止渴 、 补脾 健胃 、 调经活血
猪殃殃		清热解毒 、 散瘀 消肿 ， 淋浊 、 尿血 、 跌打损伤 等
鹿茸草		凉血止血 、 清热解毒 、 祛湿 止痛 、 解毒消肿 ， 感冒 心中 烦热 、 咳嗽 、 吐血 等
百蕊草		清热解毒 、 补肾 涩 精 、 通脉 下乳 ， 急性乳腺炎 、 肺炎 等
蓍草		祛风止痛 、 活血 、 解毒 ， 感冒 发热 、 头痛 等
亚麻		平肝 、 补虚 、 活血 、 止痛 、 顺 气 、 润 肠 ， 慢性肝炎 、 睾丸炎 等
南天竹		清热燥湿 、 止咳平喘
杠板归		利水 消肿 、 清热 、 活血 、 解毒 ， 水肿 、 黄疸 、 泄泻 等
藏菖蒲		温胃 、 消炎 止痛 ； 补 胃阳 、 消化不良 、 食物 积滞 、 白喉 、 炭疽 等
爵床		清热解毒 、 利湿 消 滞 、 活血止痛 ， 感冒 发热 等
盐肤木		祛 风湿 、 散 瘀血 、 清热解毒 ， 咳嗽 、 风湿骨痛 、 水肿 等
甲鱼		补阴 、 清热凉血 作用
虎耳草		祛风 、 清热 、 凉血 、 解毒 ， 风疹 、 中耳炎 、 丹毒 等
雪胆		清热 、 解毒 、 消肿 、 止痛 ， 咽喉肿痛 等
红景天		益气活血 、 通脉平 喘 ， 气虚血瘀 、 胸痹 心痛 、 中风 偏瘫 、 倦怠 气喘
独一味		活血 止血 、 祛风止痛 、 干 黄水 的 作用 ， 治疗 跌打损伤 、 外伤 出血 、 风湿痹 痛 、 黄水疮
冬葵果		清热 利尿 、 消肿 ， 临床 尿闭 、 水肿 、 口渴 、 尿路感染
哈蟆油		补肾益精 、 养阴润肺 ， 阴虚体 弱 、 神疲乏力 、 心悸失眠 、 盗汗 不止 、 痨 嗽 咳血
石上柏		辛温解表 、 祛风除湿 ， 咽喉肿痛 、 目赤 肿 痛 、 肺热咳嗽 等
大麻药		镇痛 、 消肿 止血 ， 风湿痛 等
黄鳝		活血
喜树		清热 、 抗 肿瘤 ， 各种 癌症 、 急 慢性白血病 、 银屑病 、 肝脾肿大
九节茶		抗菌消炎 、 祛风除湿 、 活血止痛 ， 肺炎 等
糙苏		清热 消肿 ， 虫 咬 伤 等
石蒜		祛痰 、 利尿 解毒 、 催吐
景天三七		止血 、 化瘀 ， 吐血 、 衄血 、 便血 等
三叶草		止咳平喘 ， 咳嗽 等
马铃薯		和胃 健 中 、 解毒消肿 ， 胃痛 、 痈肿 、 湿疹 等
红根草		清热解毒 、 涩肠止痢 ， 菌 痢
陆英		祛风除湿 ， 风湿痹 痛 、 脚气 、 皮肤瘙痒
草乌叶		清热 、 解毒 、 止痛 ， 临床 热病 发热 、 泄泻 腹痛 、 头痛 、 牙痛
水蜈蚣		疏风 解毒 、 利湿 退 黄 、 消肿止痛
柽柳		疏风散寒 、 解表 止咳 、 升 散 透疹 、 祛风除湿 、 消痞 解 酒 ， 麻疹 难 透 、 风疹 身痒 、 感冒 、 咳喘 等
千日红		清肝 、 散结 、 止咳定喘 ， 头风 、 目痛 等
石刁柏		清热利湿 、 活血散结
鹤草芽		杀 虫 ， 绦虫病
臭灵丹		清热解毒 、 杀 虫 疗 伤 截疟 ， 上呼吸道感染 等
杜鹃		止血
断血流		止血 的 作用 ， 崩漏 、 尿血 、 鼾 衄 、 牙龈出血 、 创伤 出血 、 子宫肌瘤 出血
草血竭		活血散 血 、 和胃止痛 、 下气 消食 、 消痞散结 、 利尿 消肿 ， 慢性胃炎 、 胃 及 十二指肠溃疡 、 外伤 出血
鲈鱼		补虚
草莓		止咳 、 清热解毒
黑种草子		补肾 健 脑 、 通经 、 通乳 、 利尿 作用 ； 耳鸣 健忘 、 经闭 乳少 、 热淋 、 石淋
烟草		行气止痛 、 解 毒杀 虫 ， 食 滞 饱 胀 、 气结 疼痛 等
委陵菜		清热解毒 、 凉血止痢 ， 赤痢 腹痛 、 久痢 不止 、 痔疮 出血 、 痈肿 疮 毒
蓼蓝		清热解毒 、 凉血止血
青叶胆		清肝利胆 、 清热利湿 ， 黄疸 尿 赤 、 热淋 涩 痛
飞扬草		清热利湿 、 解毒消肿 ， 疟疾 等
南瓜子		驱虫 、 利尿 、 止咳 ， 绦虫 、 蛔虫 等
松塔		止咳化痰 ， 慢性气管炎 、 咳嗽 等
番茄		生津止渴 、 健脾消食 ， 口渴 、 食欲不振
黑蚂蚁		解毒消肿 、 祛 风湿
山银花		清热解毒 、 凉 散 风热 ， 痈肿 疔疮 、 喉痹 、 丹毒 、 热毒 血痢 、 风热感冒 、 温热 发病
岩白菜		滋补 强 壮 、 止血 化痰 、 清热 ， 虚弱 头晕 、 劳伤 咳嗽 等
关黄柏		清热燥湿 、 泻火 除 蒸 、 解毒 疗 疮 ， 湿热 泻痢 、 黄疸 、 带下 、 热淋 、 脚气 、 痿躄 、 骨蒸 劳热 、 盗汗 、 遗精 、 疮疡 肿毒 、 湿疹 瘙 痒
龙须藤		清热解毒 、 利尿 通淋 、 祛风止痛 ， 咽喉肿痛 等
八角莲		清热解毒 、 化痰散结 、 祛瘀消肿 ， 痈肿 、 瘰疬 、 喉蛾 等
牛筋草		清热利湿
罗汉松		散瘀 消肿 、 清热解毒 ， 跌打损伤 、 疼痛
缬草		镇静 安神 、 活血祛瘀 、 温经散寒 ， 心神不安 等
柿树		清 湿热 、 利 肝胆 、 活血化瘀
落新妇		辛凉解表 、 活血祛瘀 、 止痛 、 解毒 ， 风热感冒 、 头身疼痛 等
洋葱		清热解毒
大叶桉		清热解毒 、 收敛 生 肌 ， 感冒 、 急性 肠炎 、 痢疾 等
瓜子金		化痰止咳 、 活血 止血 、 安神 、 清热解毒 ， 咳嗽 、 失眠 等
灵猫香		辟 秽 、 行气 、 止痛 ， 心腹 卒 痛 、 疝气 痛 、 心绞痛 等
枸骨叶		清热养阴 、 平肝 、 益肾 ， 肺劳 咳血 、 骨蒸潮热 、 头晕目眩 、 高血压