甘草		补脾益气、清热解毒、祛痰止咳、缓急止痛、调和诸药的功效，临床用于治疗脾胃虚弱，倦怠乏力，心悸气短，咳嗽痰多，脘腹、四肢挛急疼痛，痈肿疮毒，缓解药物毒性、烈性
当归		补血活血、调经止痛、润肠通便的功效，用于血虚萎黄、眩晕心悸、月经不调、经闭痛经、虚寒腹痛、肠燥便秘、风湿痹痛、跌扑损伤、痈疽疮疡
茯苓		利水渗湿、健脾宁心的功效，临床用于治疗水肿尿少、痰饮眩晕、脾虚食少、便溏泄泻、心神不安、惊悸失眠
人参		大补元气、复脉固脱、补脾益肺、生津、安神的功效，临床用于治疗体虚欲脱、肢冷脉微、脾虚食少、肺虚喘咳、津伤口渴、内热消渴、久病虚羸、惊悸失眠、阳痿宫冷、心力衰竭、心源性休克等
白术		健脾益气、燥湿利水、止汗、安胎的功效，临床用于治疗脾虚食少、腹痛泄泻、痰饮眩晕、水肿、自汗、胎动不安
黄芩		清热燥湿、泻火解毒、止血、安胎的功效，临床用于治疗湿温、暑温胸闷呕恶、湿热痞满、泻痢、黄疸、肺热咳嗽、高热烦渴、血热吐衄、痈肿疮毒、胎动不安
防风		解表祛风、胜湿、止痉的功效，临床用于治疗感冒头痛、风湿痹痛、风疹瘙痒、破伤风
川芎		活血行气、祛风止痛的功效，临床用于治疗经闭痛经、癥瘕腹痛、胸胁刺痛、跌扑肿痛、头痛、风湿痹痛
木香		行气止痛、健脾消食的功效，临床用于治疗胸脘胀痛、泻痢后重、食积不消、不思饮食
黄连		清热燥湿、泻火解毒的功效，临床用于治疗湿热痞满、呕吐吞酸、泻痢、黄疸、高热神昏、心火亢盛、心烦不寐、血热吐衄、目赤、牙痛、消渴、痈肿疔疮，外治湿疹、湿疮、耳道流脓
大黄		泻热通肠、凉血解毒、逐瘀通经的功效，临床用于治疗实热便秘、积滞腹痛、泻痢不爽、湿热黄疸、血热吐衄、目赤、咽肿、肠痈腹痛、痈肿疔疮、瘀血经闭、跌扑损伤，外治水火烫伤、上消化道出血
半夏		燥湿化痰、降逆止呕、消痞散结的功效，临床用于治疗痰多咳喘、痰饮眩悸、风痰眩晕、痰厥头痛、呕吐反胃、胸脘痞闷、梅核气，生用外治痈肿痰核
陈皮		理气健脾、燥湿化痰的功效，临床用于治疗胸脘胀满、食少吐泻、咳嗽痰多
白芍		平肝止痛、养血调经、敛阴止汗的功效，临床用于治疗头痛目眩、胁痛、腹痛、四肢挛痛、血虚萎黄、月经不调、自汗、盗汗
麝香		开窍醒神、活血通经、消肿止痛的功效，临床用于治疗热病神昏、中风痰厥、气郁暴厥、中恶昏迷、经闭、癥瘕、难产死胎、心腹暴痛、痈肿瘰疬、咽喉肿痛、跌扑伤痛、痹痛麻木等
枳壳		理气宽中、行滞消胀的功效，临床用于治疗胸胁气滞、胀满疼痛、食积不化、痰饮内停、胃下垂、脱肛、子宫脱垂
干姜		温中散寒、回阳通脉、燥湿消痰的功效，用于脘腹冷痛、呕吐泄泻、肢冷脉微、痰饮喘咳
附子		回阳救逆、补火助阳、逐风寒湿邪的功效，临床用于治疗亡阳虚脱、肢冷脉微、阳痿、宫冷、心腹冷痛、虚寒吐泻、阴寒水肿、阳虚外感、寒湿痹痛
桔梗		宣肺、利咽、祛痰、排脓的功效，临床用于治疗咳嗽痰多、胸闷不畅、咽痛、音哑、肺痈吐脓、疮疡脓成不溃
柴胡		和解表里、疏肝、升阳的功效，临床用于治疗感冒发热、寒热往来、胸胁胀痛、月经不调、子宫脱垂、脱肛
白芷		散风除湿、通窍止痛、消肿排脓的功效，临床用于治疗感冒头痛、眉棱骨痛、鼻渊、牙痛、白带、疮疡肿痛
生姜		解表散寒、温中止呕、化痰止咳的功效，用于风寒感冒，胃寒呕吐，寒痰咳嗽
赤芍		清热凉血、散瘀止痛的功效，临床用于温毒发斑、吐血衄血、目赤肿痛、肝郁胁痛、经闭痛经、癥瘕腹痛、跌扑损伤、痈肿疮疡
厚朴		燥湿消痞、下气除满的功效，临床用于治疗湿滞伤中、脘痞吐泻、食积气滞、腹胀便秘、痰饮喘咳
乳香		调气活血、止痛、追毒的功效，临床用于治疗气血凝滞、心腹疼痛、痈疮肿毒等
槟榔		杀虫消积、降气、行水、截疟的功效，用于绦虫、蛔虫、姜片虫病、虫积腹痛、积滞泻痢、里急后重、水肿脚气、疟疾
羌活		散寒、祛风、止痛的功效，临床用于治疗风寒感冒头痛、风湿痹痛、肩背酸痛
细辛		祛风散寒、通窍止痛、温肺化饮的功效，临床用于治疗风寒感冒、头痛、牙痛、鼻塞鼻渊、风湿痹痛、痰饮喘咳
黄柏		清热燥湿、泻火除蒸、解毒疗疮的功效，临床用于治疗湿热泻痢、黄疸、带下、热淋、脚气、痿躄、骨蒸劳热、盗汗、遗精、疮疡肿毒、湿疹瘙痒
升麻		发表透疹、清热解毒、升举阳气的功效，临床用于治疗风热头痛、齿痛、口疮、咽喉肿痛、麻疹不透、阳毒发斑、脱肛、子宫脱垂
朱砂		清心镇惊、安神解毒功效，用于心悸易惊、失眠多梦、癫痫发狂、小儿惊风、视物昏花、口疮、喉痹、疮疡肿毒
荆芥		解表散风、透疹的功效，临床用于治疗感冒、头痛、麻疹、风疹、疮疡初起收涩止血的功效，用于治疗便血、崩漏、产后血晕解表散风、透疹功效，用于治疗感冒、头痛、麻疹、风疹、疮疡初起收涩止血功效，用于治疗便血、崩漏、产后血晕
香附		行气解郁、调经止痛的功效，临床用于治疗肝郁气滞，胸、胁、脘腹胀痛，消化不良，胸脘痞闷，寒疝腹痛，乳房胀痛，月经不调，经闭痛经
雄黄		解毒杀虫、燥湿祛痰、截疟的功效，临床用于治疗痈肿疔疮、蛇虫咬伤、虫积腹痛、惊痫、疟疾
苍术		燥湿健脾、祛风散寒、明目的功效，临床用于治疗脘腹胀满、泄泻、水肿、脚气痿躄、风湿痹痛、风寒感冒、夜盲
石膏		清热泻火、除烦止渴的功效，用于外感热病、高热烦渴、肺热喘咳、胃火亢盛、头痛、牙痛
牛膝		补肝肾、强筋骨、逐瘀通经、引血下行的功效，临床用于治疗腰膝酸痛、筋骨无力、经闭癥瘕、肝阳眩晕
麻黄		发汗散寒、宣肺平喘、利水消肿的功效，临床用于治疗风寒感冒、胸闷喘咳、风水浮肿、支气管哮喘
没药		散血去瘀、消肿定痛的功效，临床用于治疗跌打损伤、金疮、癥瘕等
丁香		温中降逆、补肾助阳的功效，临床用于治疗脾胃虚寒、呃逆呕吐、食少吐泻、心腹冷痛、肾虚阳痿等
薄荷		宣散风热、清头目、透疹的功效，临床用于治疗风热感冒、风温初起、头痛、目赤、喉痹、口疮、风疹、麻疹、胸胁胀闷
栀子		泻火除烦、清热利尿、凉血解毒的功效，临床用于治疗热病心烦、黄疸尿赤、血淋涩痛、血热吐衄、目赤肿痛、火毒疮疡，外治扭挫伤痛凉血止血的功效，用于血热吐衄、尿血崩漏
芍药		清热凉血功效
五味子		收敛固涩、益气生津、补肾宁心的功效，临床用于治疗久嗽虚喘、梦遗滑精、遗尿尿频、久泻不止、自汗、盗汗、津伤口渴、短气脉虚、内热消渴、心悸失眠
知母		清热泻火、生津润燥的功效，临床用于治疗外感热病、高热烦渴、肺热燥咳、骨蒸潮热、内热消渴、肠燥便秘
连翘		清热解毒、消肿散结的功效，临床用于治疗痈疽、瘰疬、乳痈、丹毒、风热感冒、湿病初起、温热入营、高热烦渴、神昏发斑、热淋尿闭
木通		清心火、利小便、通经下乳的功效，临床用于治疗胸中烦热、喉痹咽痛、尿赤、五淋、水肿、周身挛痛、经闭乳少
青皮		疏肝破气、消积化滞的功效，临床用于治疗胸胁胀痛、疝气、乳核、乳痈、食积腹痛
泽泻		利小便、清湿热的功效，临床用于治疗小便不利、水肿胀满、泄泻尿少、痰饮眩晕、热淋涩痛、高血脂
山药		补脾养胃、生津益肺、补肾涩精的功效，用于脾虚食少、久泻不止、肺虚喘咳、肾虚遗精、带下、尿频、虚热消渴
巴豆		药材为双子叶植物药大戟科巴豆属植物巴豆的干燥成熟果实，外用蚀疮，用于恶疮疥癣、疣痣。外用适量，研末涂患处，或捣烂以纱布包擦患处。
砂仁		化湿开胃、温脾止泻、理气安胎的功效，用于湿浊中阻、脘痞不饥、脾胃虚寒、呕吐泄泻、妊娠恶阻、胎动不安
麦冬		养阴生津、润肺清心的功效，临床用于治疗肺燥干咳、虚痨咳嗽、津伤口渴、心烦失眠、内热消渴、肠燥便秘、咽白喉
肉桂		补火助阳、引火归源、散寒止痛、活血通经的功效，临床用于治疗阳痿、宫冷、腰膝冷痛、肾虚作喘、阳虚眩晕、目赤咽痛、心腹冷痛、虚寒吐泻、寒疝、奔豚、经闭、痛经
僵蚕		祛风定痉、化痰散结的功效，用于惊风抽搐、咽喉肿痛、皮肤瘙痒、颌下淋巴结炎、面神经麻痹
生地黄		清热凉血、养阴、生津的功效，临床用于治疗热病舌绛烦渴、阴虚内热、骨蒸劳热、内热消渴、吐血、衄血、发斑发疹
远志		安神益智、祛痰、消肿的功效，临床用于治疗心肾不交引起的失眠多梦、健忘惊悸、神志恍惚、咳痰不爽、疮疡肿毒、乳房肿痛
桃仁		活血祛瘀、润肠通便的功效，临床用于治疗经闭、痛经、癥瘕痞块、跌扑损伤
玄参		凉血滋阴、泻火解毒的功效，临床用于治疗热病伤阴、舌绛烦渴、温毒发斑、津伤便秘、骨蒸劳嗽、目赤、咽痛、瘰疬、白喉、痈肿疮毒
独活		祛风除湿、通痹止痛的功效，临床用于治疗风寒湿痹、腰膝酸痛、少阴伏风头痛
犀角		清热、凉血、定惊、解毒的功效，临床用于治疗伤寒温疫热入血分、惊狂等
沉香		行气止痛、温中止呕、纳气平喘的功效，临床用于治疗胸腹胀闷疼痛、胃寒呕吐呃逆、肾虚气逆喘急
天麻		平肝熄风止痉，用于头痛眩晕、肢体麻木、小儿惊风、癫痫抽搐、破伤风
龙骨		镇惊安神、敛汗固精、止血涩肠、生肌敛疮的功效
冰片		开窍醒神、清热止痛的功效，临床用于用于热病神昏、惊厥、中风痰厥、气郁暴厥、中恶昏迷、目赤、口疮、咽喉肿痛、耳道流脓
白矾		为硫酸盐类矿物明矾石经加工提炼制成，主含含水硫酸铝钾。外用解毒杀虫、燥湿止痒，内服止血止泻、祛除风痰，外治用于湿疹、疥癣、聤耳流脓，内服用于久泻不止、便血、崩漏、癫痫发狂。枯矾收湿敛疮、止血化腐，用于湿疹湿疮、聤耳流脓、阴痒带下、鼻衄齿衄、鼻瘜肉。
红花		活血通经、散瘀止痛的功效，临床用于治疗经闭、痛经、恶露不行、癥瘕痞块、疮疡肿痛
枳实		破气消积、化痰散痞的功效，临床用于治疗积滞内停、痞满胀痛、泻痢后重、大便不通、痰滞气阻胸痹、结胸、胃下垂、脱肛、子宫脱垂
滑石		利尿通淋、清热解毒、祛湿敛疮的功效，临床用于治疗热淋、石淋、尿热涩痛、暑热烦渴、湿热水泻，外治湿疹、湿疮、痱子
牛黄		清心、豁痰、开窍、凉肝、熄风、解毒的功效，临床用于治疗热病神昏、中风痰迷、惊痫抽搐、癫痫发狂、咽喉肿痛、口舌生疮、痈肿疔疮
阿胶		补血滋阴、润燥、止血的功效，临床用于治疗血虚萎黄、眩晕心悸、肌痿无力、心烦不眠、虚风内动、肺燥咳嗽、劳嗽咯血、吐血尿血、便血崩漏、妊娠胎漏
轻粉		为氯化亚汞，外用杀虫、攻毒、敛疮，内服祛痰消积、逐水通便，外治用于疥疮、顽癣、臁疮、梅毒、疮疡、湿疹，内服用于痰涎积滞、水肿臌胀、二便不利。
吴茱萸		散寒止痛、降逆止呕、助阳止泻的功效，临床用于治疗厥阴头痛、寒疝腹痛、寒湿脚气、经行腹痛、脘腹胀痛、呕吐吞酸、五更泄泻，外治口疮、高血压
前胡		散风清热、降气化痰的功效，临床用于治疗风热咳嗽痰多、痰热喘满、咯痰黄稠
神曲		健脾和胃、消食调中的功效，临床用于治疗饮食停滞、胸痞腹胀等
川乌		祛风除湿、温经止痛、麻醉止痛的功效，临床用于治疗风寒湿痹、关节疼痛、心腹冷痛、寒疝作痛、麻醉止痛
杜仲		补肝肾、强筋骨、安胎的功效，临床用于治疗肾虚腰痛、筋骨无力、妊娠漏血、胎动不安、高血压
地骨皮		凉血除蒸、清肺降火的功效，临床用于治疗阴虚潮热、骨蒸盗汗、肺热咳喘、咯血、衄血、内热消渴
全蝎		熄风镇痉、攻毒散结、通络止痛的功效，临床用于治疗小儿惊风、抽搐痉挛、中风口?、半身不遂、破伤风、风湿顽痹、偏正头痛、疮疡、瘰疬
车前子		清热利尿、渗湿通淋、明目、祛痰的功效，临床用于治疗水肿胀满、热淋涩痛、暑湿泄泻、目赤肿痛、痰热咳嗽
熟地黄		滋阴补血、益髓填精的功效，临床用于治疗肝肾阴虚、腰膝酸软、骨蒸潮热、盗汗遗精、内热消渴、血虚萎黄、心悸怔忡、月经不调、崩漏下血、眩晕、耳鸣、须发早白
菟丝子		滋补肝肾、固精缩尿、安胎、明目、止泻的功效，临床用于治疗阳痿遗精、尿有余沥、遗尿尿频、腰膝酸软、目昏耳鸣、肾虚胎漏、胎动不安、脾肾虚泻，外治白癜风
葛根		解肌退热、生津、透疹、升阳止泻的功效，临床用于治疗外感发热头痛、项背强痛、口渴、消渴、麻疹不透、热痢、泄泻、高血压颈项强痛
青黛		清热解毒、凉血、定惊的功效，临床用于治疗温毒发斑、血热吐衄、胸痛咳血、口疮、痄腮、喉痹、小儿惊痫，宜入丸散，外用适量
山楂		消食健胃、行气散瘀的功效，临床用于治疗肉食积滞、胃脘胀满、泻痢腹痛、瘀血经闭、产后瘀阻、心腹刺痛、疝气疼痛、高脂血症
乌梅		敛肺、涩肠、生津、安蛔的功效，临床用于治疗肺虚久咳、久痢滑肠、虚热消渴，蛔厥呕吐腹痛、胆道蛔虫症
三棱		破血行气、消积止痛的功效，用于癥瘕痞块、瘀血经闭、食积胀痛
菊花		散风清热、平肝明目的功效，临床用于治疗风热感冒、头痛眩晕、目赤肿痛、眼目昏花
丹参		祛瘀止痛、活血通经、安神宁心、排脓、止痛的功效，临床用于治疗心绞痛等
牡蛎		重镇安神、潜阳补阴、软坚散结的功效，临床用于治疗惊悸失眠、眩晕耳鸣、瘰疬痰核、癥瘕痞块
白附子		祛风痰、定惊搐、解毒散结止痛的功效，临床用于治疗中风痰壅、口眼喎斜、语言涩謇，痰厥头痛，偏正头痛、喉痹咽痛、破伤风，外治瘰疬痰核、毒蛇咬伤
硫黄		为自然元素类矿物硫族自然硫。采挖后，加热溶化，除去杂质，或用含硫矿物经加工制得。外用解毒杀虫疗疮，内服补火助阳通便，外治用于疥癣、秃疮、阴疽恶疮，内服用于阳痿足冷、虚喘冷哮、虚寒便秘。
天南星		燥湿化痰、祛风止痉、散结消肿的功效，用于顽痰咳嗽、风痰眩晕、中风痰壅、口眼歪斜、半身不遂、癫痫、惊风、破伤风，生用外治痈肿、蛇虫咬伤
草乌		祛风除湿、温经止痛的功效，临床用于治疗风寒湿痹、关节疼痛、心腹冷痛、寒疝伤痛及麻醉止痛
肉豆蔻		温中行气、涩肠止泻的功效，临床用于治疗脾胃虚寒、久泻不止、脘腹胀痛、食少呕吐
茴香		散寒止痛、温肾缩尿、理气和胃、祛湿利浊的功效，临床用于治疗寒疝、少腹冷痛、肾虚腰痛等
羚羊角		平肝熄风、清肝明目、散血解毒的功效，临床用于治疗高热惊痫、神昏痉厥、子痫抽搐、癫痫发狂、头痛眩晕、目赤翳障、温毒发斑、痈肿疮毒
莪术		行气破血、消积止痛的功效，临床用于治疗癥瘕痞块、瘀血经闭、食积胀痛、早期宫颈癌
苦参		清热燥湿、杀虫、利尿的功效，临床用于治疗热痢、便血、黄疸尿闭、赤白带下、阴肿阴痒、湿疹、湿疮、皮肤瘙痒、疥癣麻风，外治滴虫性阴道炎
蒺藜		平肝解郁、活血祛风、明目、止痒的作用，临床用于治疗头痛眩晕、胸胁胀痛、乳闭乳痈、目赤翳障，风疹瘙痒
乌药		顺气止痛、温肾散寒的功效，临床用于治疗胸腹胀痛，气逆喘急、膀胱虚冷，遗尿，疝气，痛经
桂枝		发汗解肌、温通经脉、助阳化气、平冲降气的功效，临床用于治疗风寒感冒、脘腹冷痛、血寒经闭、关节痹痛、痰饮、水肿、心悸、奔豚
秦艽		祛风湿、清湿热、止痹痛的功效，临床用于治疗风湿痹痛、筋脉拘挛、骨节酸痛、日晡潮热、小儿疳积发热
肉苁蓉		补肾阳、益精血、润肠通便，用于阳痿、不孕、腰膝酸软、筋骨无力、肠燥便秘
郁金		行气化瘀、清心解郁、利胆退黄的功效，临床用于治疗经闭痛经，胸腹胀痛、刺痛，热病神昏、癫痫发狂、黄疸尿赤
木瓜		平肝舒筋、和胃化湿的功效，临床用于治疗湿痹拘挛、腰膝关节酸重疼痛、吐泻转筋、脚气水肿
琥珀		镇惊安神、散瘀止血、利水通淋的功效
炙甘草		补脾和胃、益气复脉的功效，临床用于治疗脾胃虚弱、倦怠乏力、心动悸、脉结代
硼砂		清热消痰、解毒防腐的功效
血竭		祛瘀定痛、止血生肌的功效，临床用于治疗跌扑折损、内伤瘀痛、外伤出血不止
金银花		清热解毒、凉散风热的功效，临床用于治疗痈肿疔疮、喉痹、丹毒、热毒血痢、温病发热
山茱萸		补益肝肾、涩精固脱的功效，临床用于治疗眩晕耳鸣、腰膝酸痛、阳痿遗精、遗尿尿频、崩漏带下、大汗虚脱、内热消渴
防己		利水消肿、祛风止痛的功效，临床用于治疗水肿脚气、小便不利、湿疹疮毒、风湿痹痛、高血压
枸杞子		滋补肝肾、益精明目的功效，临床用于治疗虚劳精亏、腰膝酸痛、眩晕耳鸣、内热消渴、目昏不明
赤石脂		涩肠、止血、生肌敛疮的功效，临床用于治疗久泻久痢、大便出血、崩漏带下，外治疮疡不敛、湿疹脓水浸淫
续断		补肝肾、强筋骨、续折伤、止崩漏的功效，临床用于治疗腰膝酸软，风湿痹痛、崩漏、跌扑损伤
天花粉		清热生津、排脓消肿的功效，临床用于治疗热病烦渴、肺热燥咳、内热消渴、疮疡肿毒
大枣		补中益气、养血安神的功效，临床用于治疗脾虚食少、乏力便溏、妇人脏躁等
紫菀		润肺下气、消痰止咳的功效，临床用于治疗痰多喘咳、新久咳嗽、劳嗽咳血
桑白皮		泻肺平喘、利水消肿的功效，临床用于治疗肺热喘咳、水肿胀满尿少、面目肌肤浮肿
橘红		散寒、燥湿、利气、消痰的功效，临床用于治疗风寒痰嗽、喉痒痰多、食积伤酒、呕恶痞闷
五灵脂		行血止痛、活血止血、解毒、健脾消积的功效，临床用于治疗心腹血气诸痛、崩漏等
龙胆		清热燥湿、泻肝胆火的功效，临床用于治疗湿热黄疸、阴肿阴痒、带下、强中、湿疹瘙痒、目赤、耳聋、胁痛、口苦、惊风抽搐
麦芽		行气消食、健脾开胃、退乳消胀的功效，临床用于治疗食积不消、脘腹胀满、脾虚食少、乳汁郁积，乳房胀痛、妇女断乳
石斛		益胃生津、滋阴清热的功效，用于阴伤津亏、口干烦渴、食少干呕、病后虚热、目暗不明
石菖蒲		化湿开胃、开窍豁痰、醒神益智的功效，用于脘痞不饥、噤口下痢、神昏癫痫、健忘耳聋
党参		补中益气、健脾益肺的功效，临床用于治疗脾肺虚弱、气短心悸、食少便溏、虚喘咳嗽、内热消渴
鳖甲		滋阴潜阳、软坚散结、退热除蒸的功效，临床用于治疗阴虚发热、劳热骨蒸、虚风内动、经闭、癥瘕、久疟疟母
蒲黄		止血、化痰、通淋的功效；临床用于治疗吐血、衄血、咯血、崩漏、外伤出血、经闭痛经、脘腹刺痛、跌扑肿痛、血淋涩痛
牡丹皮		清热凉血、活血化瘀的功效，临床用于治疗温热发斑、吐血衄血、夜热早凉、无汗骨蒸、经闭痛经、痈肿疮毒、跌扑伤痛
地榆		凉血止血、解毒敛疮的功效，临床用于治疗便血、痔血、血痢、崩漏、水火烫伤、痈肿疮毒
牵牛		利水消肿的功效
牛蒡子		疏散风热、宣肺透疹、解毒利咽的功效，临床用于治疗风热感冒、咳嗽痰多、麻疹、风疹、咽喉肿痛、痄腮、丹毒、痈肿疮毒
蝉蜕		散风除热、利咽、透疹、退翳、解痉的功效，临床用于治疗风热感冒、咽痛、音哑、麻疹瘙痒、目赤翳障、惊风抽搐、破伤风
猪苓		利水渗湿的功效，用于小便不利、水肿、泄泻、淋浊、带下
鹿茸		壮肾助阳、益精血、强筋骨、调冲任、托疮毒的功效，临床用于治疗阳痿滑精、宫冷不孕、赢瘦、神疲、畏寒、眩晕耳鸣耳聋、腰脊冷痛、筋骨痿软、崩漏带下、阴疽不敛
黄芪		补气固表、利尿托毒、排脓、敛疮生肌的功效，临床用于治疗气虚乏力、食少便溏、中气下陷、久泻脱肛、便血崩漏、表虚自汗、气虚水肿、痈疽难溃、久溃不敛、血虚痿黄、内热消渴、慢性肾炎蛋白尿、糖尿病
诃子		涩肠敛肺、降火利咽的功效，临床用于治疗久泻久痢、便血脱肛、肺虚喘咳、久嗽不止、咽痛音哑
蜈蚣		熄风镇痉、攻毒散结、通络止痛的功效，用于小儿惊风、抽搐痉挛、中风口?、半身不遂、破伤风、风湿顽痹、疮疡、瘰疬、毒蛇咬伤
豆蔻		化湿消痞、行气温中、开胃消食的功效，用于治疗湿浊中阻、不思饮食、湿温初起、胸闷不饥、寒湿呕逆、胸腹胀痛、食积不消
柏子仁		养心安神、止汗、润肠的功效，临床用于治疗虚烦失眠、心悸怔忡、阴虚盗汗、肠燥便秘
地龙		清热定惊、平喘、利尿的功效，临床用于高热神昏、惊痫抽搐、关节痹痛、肢体麻木、半身不遂、肺热喘咳、尿少水肿、高血压
寒水石		清热降火、利窍消肿的功效
白及		收敛止血、消肿生肌的功效，临床用于治疗咯血吐血、外伤出血、疮疡肿毒、皮肤皲裂、肺结核咯血、溃疡病出血
蛇床子		温肾壮阳、燥湿、祛风、杀虫的功效，临床用于治疗阳痿、宫冷、寒湿带下、湿痹腰痛，外治外阴湿疹、妇人阴痒、滴虫性阴道炎
酸枣仁		补肝、宁心、敛汗、生津的功效，临床用于治疗虚烦不眠、惊悸多梦、体虚多汗、津伤口渴
何首乌		解毒、消痈、润肠通便的功效，临床用于治疗瘰疬疮痈、风疹瘙痒、肠燥便秘、高血脂
五倍子		敛肺降火、涩肠止泻、敛汗止血、收湿敛疮的功效，临床用于治疗肺虚久咳、肺热痰嗽、久泻久痢、盗汗、消渴、便血痔血、外伤出血、痈肿疮毒、皮肤湿烂
胡黄连		清湿热、除骨蒸、消疳热的功效，临床用于治疗湿热泻痢、黄疸、痔疾、骨蒸潮热、小儿疳热
威灵仙		祛风除湿、通络止痛的功效，临床用于治疗风湿痹痛、肢体麻木、筋脉拘挛、屈伸不利、骨哽咽喉
胡椒		温中散寒、下气、消痰的功效，临床用于治疗胃寒呕吐、腹痛泄泻、食欲不振、癫痫痰多
珍珠		安神定惊、明目消翳、解毒生肌的功效，临床用于治疗惊悸失眠、惊风癫痫、目生云翳、疮疡不敛
穿山甲		通经下乳、消肿排脓、搜风通络的功效，临床用于治疗经闭癥瘕、乳汁不通、痈肿疮毒、关节痹痛、麻木拘挛
瓜蒌		清热涤痰、宽胸散结、润燥滑肠的功效，临床用于肺热咳嗽、痰浊黄稠、结胸痞满、乳痈、肺痈、肠痈肿痛、大便秘结
藁本		祛风、散寒、除湿、止痛的功效，用于风寒感冒、巅顶疼痛、风湿肢节痹痛
儿茶		生肌敛疮的功效，临床用于治疗溃疡不敛等
芦荟		清肝热、通便的功效，临床用于治疗便秘、小儿疳积、惊风，外治湿癣
大腹皮		下气宽中、行水消肿的功效，用于湿阻气滞、脘腹胀闷、大便不爽、水肿胀满、脚气浮肿、小便不利
茵陈		清湿热、退黄疸的功效，临床用于治疗湿热尿少、温疮瘙痒、传染性黄疸型肝炎
白蔹		清热解毒、消痈散结的功效，临床用于治疗痈疽发背、疔疮、瘰疬、水火烫伤
益智		温脾止泻、摄唾涎、暖肾、固精缩尿的功效，用于脾寒泄泻、腹中冷痛、口多唾涎、肾虚遗尿、小便频数、遗精白浊
蟾酥		解毒、止痛、开窍醒神的功效，用于痈疽疔疮、咽喉肿痛、中暑神昏、腹痛吐泻
款冬花		润肺下气、止咳化痰的功效，临床用于治疗新久咳嗽、喘咳痰多、劳嗽咳血
赤小豆		利水消肿、解毒排脓的功效，临床用于治疗水肿胀满、脚气肢肿、黄疸尿赤、风湿热痹、痈肿疮毒、肠痈腹痛
乌头		祛风、散寒、燥湿、益火助阳的功效，临床用于治疗风寒湿痹等
艾叶		散寒止痛、温经止血的功效，临床用于治疗少腹冷痛、经寒不调、宫冷不孕、吐血、衄血、崩漏经多、妊娠下血，外治皮肤瘙痒
射干		清热解毒、消痰、利咽的功效，用于热毒痰火郁结、咽喉肿痛、痰涎壅盛、咳嗽气喘等
甘遂		泻水逐饮的功效，临床用于治疗水肿胀满、胸腹积水、痰饮积聚、气逆喘咳、二便不利
草果		燥湿温中、除痰截疟的功效，临床用于治疗寒湿内阻、脘腹胀痛、痞满呕吐、疟疾寒热
天竺黄		清热豁痰、凉心定惊的功效，临床用于治疗热病神昏、中风痰迷、小儿痰热惊痫、抽搐、夜啼
五加皮		祛风湿，补肝肾，强筋骨的功效，临床用于治疗风湿痹痛，筋骨痿软，小儿行迟，水肿、脚气
三七		散瘀止血、消肿定痛的功效，临床用于治疗咯血、吐血、衄血、便血、崩漏、外伤出血、胸腹刺痛、跌扑肿痛
薏苡仁		健脾渗湿、除痹止泻、清热排脓的功效，临床用于治疗水肿、脚气、小便不利、湿痹拘挛、脾虚泄泻、肺痈、肠痈、扁平疣
延胡索		活血、利气、止痛的功效，临床用于治疗胸胁、脘腹疼痛，经闭痛经、产后瘀阻、跌扑肿痛
葱白		辛温解表的功效
草豆蔻		燥湿健脾、温胃止呕的功效，临床用于治疗寒湿内阻、脘腹胀满冷痛、嗳气呕逆、不思饮食
蔓荆子		疏散风热、清利头目的功效，临床用于治疗风热感冒头痛、齿龈肿痛、目赤多泪、目暗不明、头晕目眩
钩藤		清热平肝、熄风定惊的功效，临床用于治疗头痛眩晕、感冒夹惊、惊痫抽搐、妊娠子痫、高血压
木鳖子		散结消肿、攻毒疗疮的功效，临床用于治疗疮疡肿毒、乳痈、瘰疬、痔漏、秃疮
补骨脂		温肾助阳、纳气、止泻的功效，临床用于治疗阳痿遗精、遗尿尿频、腰膝冷痛、肾虚作喘、五更泄泻，外用于治白癜风、斑秃
阿魏		消积、散痞、杀虫的功效，临床用于治疗瘀血癥瘕、腹中痞块、虫积腹痛
使君子		杀虫消积的功效，临床用于治疗蛔虫、蛲虫病、虫积腹痛、小儿疳积
斑蝥		破血消癥、攻毒蚀疮、引赤发泡的功效，临床用于治疗癥瘕肿块、积年顽癣、瘰疬、赘疣、痈疽不溃、恶疮死肌
郁李仁		润燥滑肠、下气、利水的功效，临床用于治疗津枯肠燥、食积气滞、腹胀便秘、水肿、脚气、小便不利
瞿麦		利尿通淋、破血通经的功效，临床用于治疗热淋、血淋、石淋、小便不通、淋沥涩痛、月经闭止
益母草		活血调经、利尿消肿的功效，临床用于治疗月经不调、痛经、经闭、恶露不尽、水肿尿少、急性肾炎水肿
高良姜		温胃散寒、消食止痛的功效，用于脘腹冷痛、胃寒呕吐、嗳气吞酸
芜荑		杀虫、消积、散寒止泻的功效，临床用于治疗虫积腹痛、小儿疳泻
百合		养阴润肺、清心安神的功效，临床用于治疗阴虚久咳、痰中带血、虚烦惊悸、失眠多梦、精神恍惚
芫花		泻水逐饮、解毒杀虫的功效，临床用于治疗水肿胀满、胸腹积水、痰饮积聚、气逆喘咳、二便不利，外治疥癣秃疮、冻疮
竹叶		清热除烦、生津利尿、化痰止咳、降逆止呕、疏风通络的功效
磁石		平肝潜阳、聪耳明目、镇惊安神、纳气平喘的功效，用于头晕目眩、视物昏花、耳鸣耳聋、惊悸失眠、肾虚气喘
川楝子		疏肝行气、驱虫的功效，临床用于治疗胸胁、脘腹胀痛、疝痛、虫积腹痛
干漆		破瘀血、消积、杀虫的功效，临床用于治疗妇女闭经、瘀血癥瘕、虫积腹痛
枇杷叶		清肺止咳、降逆止呕的功效，临床用于治疗肺热咳嗽、气逆喘急、胃热呕逆、烦热口渴
旋覆花		降气、消痰、行水、止呕的功效，临床用于治疗风寒咳嗽、痰饮蓄结、胸膈痞满、喘咳痰多、呕吐噫气、心下痞硬
竹茹		清热化痰、除烦止呕的功效，临床用于治疗痰热咳嗽、胆火挟痰、烦热呕吐、惊悸失眠、中风痰迷、舌强不语、胃热呕吐、妊娠恶阻、胎动不安
木贼		疏风热、退目翳的功效，临床用于治疗风热目赤、迎风流泪、目生云翳
白芥		温中散寒的功效，临床用于治疗咳嗽、胃痛、腹冷痛等
巴戟天		补肾阳、壮筋骨、祛风湿的功效，临床用于治疗阳痿遗精、宫冷不孕、月经不调、少腹冷痛、风湿痹痛、筋骨痿饮等
檀香		行气温中、开胃止痛的功效，临床用于治疗寒凝气滞、胸痛、腹痛、胃痛食少、冠心病、心绞痛
槐花		凉血止血、清肝泻火的功效，临床用于治疗便血、痔血、血痢、崩漏、吐血、衄血、肝热目赤、头痛眩晕
芡实		固肾涩精、补脾止泄、祛湿止带的功效，临床用于治疗梦遗滑精、遗尿尿频、脾虚久泻、白浊、带下
天冬		养阴润燥、清肺生津的功效，用于肺燥干咳、顿咳痰黏、咽干口渴、肠燥便秘
龙齿		镇惊安神、除烦热的功效，临床用于治疗惊痫、癫狂等
紫草		凉血、活血、解毒透疹的功效，临床用于治疗血热毒盛、斑疹紫黑、麻疹不透、疮疡、湿疹、水火烫伤
石决明		平肝潜阳、清肝明目的功效，临床用于治疗头痛眩晕、目赤翳障、视物昏花、青盲雀目
苏木		行血破瘀、消肿止痛的功效，临床用于治疗闭经、痛经、产后瘀阻、胸腹刺痛、外伤肿痛
熊胆		清热、镇痉、明目、杀虫的功效，临床用于治疗热黄、暑泻、小儿惊痫等
绿豆		清热解毒、消暑利水的功效，临床用于治疗暑热烦渴等
蛇蜕		祛风、定惊、解毒、退翳的功效，临床用于治疗小儿惊痫、抽搐痉挛、翳障、喉痹、疔肿、皮肤瘙痒
猪牙皂		祛痰开窍、散结消肿的功效，临床用于治疗中风口噤、昏迷不醒、癫痫痰盛、关窍不通、喉痹痰阻、顽痰喘咳、咯痰不爽、大便燥结，外治痈肿
姜黄		破血行气、通经止痛的功效，临床用于治疗胸胁刺痛、闭经、癥瘕、风湿肩臂疼痛、跌扑肿痛
萝卜		祛湿利水、消食的功效
小茴香		散寒止痛、理气和胃的功效，临床用于治疗寒疝腹痛、睾丸偏坠、痛经、少腹冷痛、脘腹胀痛、食少吐泻、睾丸鞘膜积液
自然铜		散瘀、接骨、止痛的功效，临床用于治疗跌扑肿痛、筋骨折伤
白鲜皮		清热燥湿、祛风解毒的功效，临床用于治疗湿热疮毒、黄水淋漓、风疹、疥癣疮癞、风湿热痹、黄疸尿赤
松香		祛风、燥湿、清热解毒、生肌、止痛、驱虫的功效，临床用于治疗痈疽、疔毒等
桑寄生		补肝肾、强筋骨、除风湿、安胎的功效，临床用于治疗风湿痹痛、腰膝酸软、筋骨无力、崩漏经多、妊娠漏血、胎动不安、高血压
百部		润肺下气止咳、杀虫的功效，临床用于治疗新久咳嗽、肺痨咳嗽、百日咳，外用于头虱、体虱、蛲虫病、阴痒
蜂房		祛风、攻毒、杀虫、止痛的功效，临床用于治疗龋齿牙痛、疮疡肿毒、乳痈、瘰疬、皮肤顽癣、鹅掌风
甘松		理气止痛、开郁醒脾的功效，临床用于治疗脘腹胀满、食欲不振、呕吐，外治牙痛、脚肿
泽兰		活血化瘀、行水消肿的功效，临床用于治疗月经不调、经闭、痛经、产后瘀血腹痛、水肿
鸡子		滋阴润燥、养血安胎的功效，临床用于治疗热病烦闷、燥咳声哑、目赤咽痛等
牵牛子		泻水通便、消痰涤饮、杀虫攻积的功效，临床用于治疗水肿胀满、二便不通、痰饮积聚、气逆喘咳、虫积腹痛、蛔虫、绦虫病
海螵蛸		收敛止血、涩精止带、制酸、敛疮的功效，临床用于治疗胃痛吞酸、吐血衄血、崩漏便血、遗精滑精、赤白带下、溃疡病，外治损伤出血、疮多脓汁
常山		截疟、劫痰的功效，临床用于治疗疟疾
青蒿		清热解暑、除蒸、截疟的功效，临床用于治疗暑邪发热、阴虚发热、夜热早凉、骨蒸痨热、疟疾寒热、湿热黄疸
川贝母		清热润肺、化痰止咳的功效，临床用于治疗肺热燥咳、干咳少痰、阴虚劳嗽、咯痰带血
樟脑		通窍、杀虫、止痛、辟秽的功效，临床用于治疗心腹胀痛、脚气、疮疡疥癣等
覆盆子		益肾、固精、缩尿的功效，临床用于治疗肾虚遗尿、小便频数、阳痿早泄、遗精滑精
荜茇		温中散寒、下气止痛的功效，临床用于治疗脘腹冷痛、呕吐、泄泻、偏头痛，外治牙痛
海藻		软坚散结、消痰、利水的功效，用于瘿瘤、瘰疬、睾丸肿痛、痰饮水肿
紫苏叶		解表散寒、行气和胃的功效，临床用于治疗风寒感冒、咳嗽呕恶、妊娠呕吐、鱼蟹中毒
淡竹叶		清心除烦、利尿的功效，用于热病烦渴、小便赤涩淋痛、口舌生疮
雷丸		杀虫消积的功效，用于绦虫、钩虫、蛔虫病、虫积腹痛、小儿疳积
蒲公英		清热解毒、消肿散结、利尿通淋的功效，临床用于治疗疔疮肿毒、乳痈、瘰疬、目赤、咽痛、肺痈、肠痈、湿热黄疸、热淋涩痛
鸡内金		健脾消食、涩精止遗的功效，临床用于治疗食积不消、呕吐泻痢、小儿疳积、遗尿、遗精
胆矾		催吐、祛腐解毒的功效
青木香		平肝气痛、解毒消肿的功效，临床用于治疗眩晕头痛等
桑叶		疏散风热、清肺润燥、清肝明目的功效，临床用于治疗风热感冒、肺热燥咳、头晕头痛、目赤昏花
鹿角		温肾阳、强筋骨、行血消肿的功效，临床用于治疗阳痿遗精、腰脊冷痛、阴疽疮疡、乳痈初起、瘀血肿痛
蕤仁		养肝明目、疏风散热的功效，临床用于治疗目赤肿痛、睑眩赤烂、目暗羞明
夏枯草		清火、明目、散结、消肿的功效，临床用于治疗目赤肿痛、目珠夜痛、头痛眩晕、瘰疬、瘿瘤、乳痈肿痛、甲状腺肿大、淋巴结结核、乳腺增生、高血压
通草		清热利尿、通气下乳的功效，临床用于治疗湿热尿赤、淋病涩痛、水肿尿少、乳汁不下
决明子		清肝明目、润肠通便的功效，临床用于治疗风热赤眼等
人中白		清热、降火、消瘀的功效，临床用于治疗劳热、肺痿等
芦根		清热生津、除烦、止呕、利尿的功效，临床用于治疗热病烦渴、胃热呕哕、肺热咳嗽、肺痈吐脓、热淋涩痛
虎骨		追风定痛、健骨镇惊的功效，临床用于治疗历节风痛、惊悸癫痫、痔瘘脱肛等
桑螵蛸		益肾固精、缩尿、止浊的功效，临床用于治疗遗精滑精、遗尿尿频、小便白浊
炉甘石		解毒明目退翳、收湿止痒敛疮的功效，临床用于治疗目赤肿痛、眼缘赤烂、翳膜胬肉、溃疡不敛、脓水淋漓、湿疮、皮肤瘙痒
昆布		软坚散结、消痰、利水的功效，临床用于治疗瘿瘤、瘰疬、睾丸肿痛、痰饮水肿
狗脊		补肝肾、强腰膝、祛风湿的功效，临床用于治疗腰膝酸软、下肢无力、风湿痹痛
炮姜		温中散寒、温经止血的功效，临床用于治疗脾胃虚寒、腹痛吐泻、吐衄崩漏、阳虚失血等
莲子		补脾止泻、益肾涩精、养心安神的功效，临床用于治疗脾虚久泻、遗精带下、心悸失眠
罂粟壳		敛肺、涩肠、定痛的功效，临床用于治疗久咳、久泻、脱肛、脘腹疼痛
百草霜		止血、消积、清热的功效，临床用于治疗吐血等
白薇		清热凉血、利尿通淋、解毒疗疮的功效，临床用于治疗温邪伤营发热、阴虚发热、骨蒸劳热、产后血虚发热、热淋、血淋、痈疽肿毒
白扁豆		健脾化湿、和中消暑的功效，临床用于脾胃虚弱、食欲不振、大便溏泻、白带过多、暑湿吐泻、胸闷腹胀
莱菔子		消食除胀、降气化痰的功效，临床用于治疗饮食停滞、脘腹胀痛、大便秘结、积滞泻痢、痰壅喘咳
土茯苓		除湿、解毒、通利关节的功效，用于湿热淋浊、带下、痈肿、瘰疬、疥癣、梅毒及汞中毒所致的肢体拘挛、筋骨疼痛
荷叶		清暑解暑、升发清阳、凉血止血的功效，临床用于治疗暑热烦渴、暑湿泄泻、脾虚泄泻、血热吐衄、便血崩漏
香薷		发汗解表、和中利湿的功效，临床用于治疗暑湿感冒、恶寒发热、头痛无汗、腹痛吐泻、小便不利
茺蔚子		活血调经、清肝明目的功效，临床用于治疗月经不调、经闭、痛经、目赤翳障、头晕胀痛
赭石		平肝潜阳、降逆、止血的功效，用于眩晕耳鸣、呕吐、噫气、呃逆、喘息、吐血、衄血、崩漏下血
女贞子		滋补肝肾、明目乌发的功效，临床用于治疗眩晕耳鸣、腰膝酸软、须发早白、目暗不明
鹿角胶		温补肝肾、益精养血的功效，临床用于治疗肝肾气不足所致的腰膝酸冷、阳痿遗精、虚劳羸瘦、崩漏下血、便血尿血、阴疽肿痛
水蛭		破血、逐瘀、通经的功效，用于癥瘕痞块、血瘀经闭、跌扑损伤
藜芦		涌吐风痰、清热解毒、杀虫的功效，临床用于治疗中风痰涌、风痫癫疾、黄疸等
青葙子		清肝、明目、退翳的功效，临床用于治疗肝热目赤、眼生翳膜、视物昏花、肝火眩晕
白茅根		凉血止血、清热利尿的功效，临床用于治疗血热吐血、衄血、尿血、热病烦渴、黄疸、水肿、热淋涩痛、急性肾炎水肿
漏芦		清热解毒、消痈、下乳、舒筋通脉的功效，临床用于治疗乳痈肿痛、痈疽发背、瘰疬疮毒、乳汁不通、湿痹拘挛
大豆		健脾宽中、解毒消肿、利水消积的功效，临床用于治疗疳积、泻痢等
葶苈子		泻肺平喘、行水消肿的功效，临床用于治疗痰涎壅肺、喘咳痰多、胸胁胀满、不得平卧、胸腹水肿、小便不利、肺原性心脏病水肿
石韦		利尿通淋、清热止血的功效，临床用于治疗热淋、血淋、石淋、小便不通、淋沥涩痛、吐血、衄血、尿血、崩漏、肺热喘咳
牛蒡		清肺止咳、清热解毒、清肝熄风、软坚散结的功效，临床用于治疗风毒面肿、头晕等
蓖麻子		消肿拔毒、泻下通滞的功效，临床用于治疗痈疽肿毒、喉痹、瘰疬、大便燥结
花椒		温中止痛、杀虫止痒的功效，临床用于治疗脘腹冷痛、呕吐泄泻、虫积腹痛，蛔虫症，外治湿疹瘙痒
冬葵子		祛寒的功效
紫苏子		降气消痰、平喘、润肠的功效，临床用于治疗痰壅气逆、咳嗽气喘、肠燥便秘
谷精草		疏散风热、明目、退翳，用于风热目赤、肿痛羞明、眼生翳膜、风热头痛
皂角刺		消肿托毒、排脓、杀虫的功效，临床用于治疗痈疽初起或脓成不溃，外治疥癣麻风
荜澄茄		温中散寒、行气止痛的功效，临床用于治疗胃寒呕逆、脘腹冷痛、寒疝郁滞、小便浑浊
小麦		养心、益肾、除热、止渴的功效，临床用于治疗脏躁、烦热、消渴等
铅丹		解毒祛腐、收湿敛疮、坠痰镇惊的作用
巴豆霜		峻下积滞、逐水消肿、豁痰利咽的功效，临床用于治疗寒积便秘、乳食停滞、下腹水肿、二便不通、喉风、喉痹
侧柏叶		凉血止血、生发乌发的功效，临床用于治疗吐血衄血、咯血、便血、崩漏下血、血热脱发、须发早白
淫羊藿		补肾阳、强筋骨、祛风湿的功效，临床用于治疗阳痿遗精、筋骨痿软、风湿痹痛、麻木拘挛、更年期高血压
阳起石		温肾壮阳的功效
山豆根		清热解毒、消肿利咽的功效，临床用于治疗火毒蕴结、咽喉肿痛、齿龈肿痛
紫石英		镇心安神、温肺、暖宫的功效，用于失眠多梦、心悸易惊、肺虚咳喘、宫寒不孕
安息香		开窍清神、行气活血、止痛的功效，临床用于治疗中风痰厥、气郁暴厥、中恶昏迷、心腹疼痛、产后血晕、小儿惊风
鹤虱		杀虫消积的功效，临床用于治疗蛔虫、蛲虫、绦虫病、虫积腹痛、小儿疳积
石榴皮		涩肠止泻、止血、驱虫的功效，临床用于治疗久泻、久痢、便血、脱肛、崩漏、白带、虫积腹痛
槐角		清热泻火、凉血止血的功效，临床用于治疗肠热便血、痔肿出血、肝热头痛、眩晕目赤
牛胆		清肝明目、解毒消肿、利胆通肠、清热生津的功效，临床用于治疗风热目疾、小儿惊风、痈肿等
地肤子		清热利湿、祛风止痒的功效，临床用于治疗小便涩痛、阴痒带下、湿疹、皮肤瘙痒
黄精		补气养阴、健脾、润肺、益肾的功效，用于脾胃虚弱、体倦乏力、口干食少、肺虚燥咳、精血不足、内热消渴
王不留行		活血通经、下乳消肿的功效，临床用于治疗乳汁不下、经闭、痛经、乳痈肿痛
茜草		凉血、止血、祛瘀、通经的功效，临床用于治疗吐血、衄血、崩漏、外伤出血、经闭瘀阻、关节痹痛、跌扑肿痛
紫河车		温肾补精、益气养血的功效，临床用于治疗虚损羸瘦、骨蒸盗汗、咳嗽气喘、食少气短、阳痿遗精、不孕少乳
秦皮		清热燥湿、收涩、明目的功效，临床用于治疗热痢、泄泻、赤白带下、目赤肿痛、目生翳障
瓜蒂		涌吐、去湿热、行水消肿的功效，临床用于治疗痰涎宿食等
商陆		逐水消肿、通利二便、解毒散结的功效，临床用于治疗水肿胀满、二便不通，外治痈肿疮毒
马兜铃		清肺降气、止咳平喘、清肠消痔的功效，临床用于治疗肺热喘咳、痰中带血、肠热痔血、痔疮肿痛
玄明粉		泻热通便、润燥软坚、清火消肿的功效，临床用于实热便秘、大便燥结、积滞腹痛，外治咽喉肿痛、口舌生疮、牙龈肿痛、目赤、痈肿、丹毒
降香		行气活血、止痛、止血的功效，临床用于治疗脘腹疼痛、肝郁胁痛、胸痹刺痛、跌扑损伤、外伤出血
车前		清热利尿、祛痰、凉血、解毒的功效，临床用于治疗淋证等
海桐皮		祛风湿、通经络、杀虫的功效，临床用于治疗风湿痹痛等
母丁香		温中降逆、补肾助阳的功效，临床用于治疗脾胃虚寒、呃逆呕吐、食少吐泻、心腹冷痛、肾虚阳痿
葫芦		祛湿利水的功效
桑枝		祛风湿、利关节的功效，临床用于治疗肩臂、关节酸痛麻木
苦杏仁		降气止咳平喘、润肠通便的功效，临床用于治疗咳嗽气喘、胸满痰多、血虚津枯、肠燥便秘
蜗牛		清热解毒、镇惊、消肿功效
鸡血藤		补血、活血、通络的功效，临床用于治疗月经不调、血虚萎黄、麻木瘫痪、风湿痹痛
玉竹		养阴润燥、生津止渴的功效，用于肺胃阴伤、燥伤咳嗽、咽干口渴、内热消渴
禹余粮		涩肠止泻、收敛止血的功效，临床用于治疗久泻、久痢、崩漏、白带
竹沥		清热滑痰、镇惊利窍的功效，临床用于治疗中风痰迷、肺热痰壅、惊风、癫痫等
法半夏		燥湿化痰的功效，临床用于治疗痰多咳喘、痰饮眩晕、风痰眩晕、痰厥头痛
苍耳子		散风除湿、通鼻窍的功效，临床用于治疗风寒头痛、鼻渊流涕、风疹瘙痒、湿痹拘挛
板蓝根		清热解毒、凉血利咽的功效，临床用于治疗温毒发斑、舌绛紫暗、痄腮、喉痹、烂喉丹痧、大头瘟疫、丹毒、痈肿
金樱子		固精涩尿、涩肠止泻的功效，临床用于治疗遗精滑精、遗尿尿频、崩漏带下、久泻久痢
大麦		和胃、宽肠、利水的功效
胆南星		清火化痰、熄风定惊的功效，临床用于治疗痰热咳嗽、咯痰黄稠、中风痰迷、癫狂惊痫
刘寄奴		破血通经、敛疮消肿、醒脾消食的功效，临床用于治疗经闭癥瘕、胸腹胀痛、痈毒脓肿等证
牡丹		清热凉血功效
浮萍		宣散风热、透疹、利尿的功效，用于麻疹不透、风疹瘙痒、水肿尿少
冬瓜		利水消痰、清热解毒的功效，临床用于治疗水肿等
薤白		通阳散结、行气导滞的功效，用于胸痹疼痛、痰饮咳喘、泄痢后重
零陵香		祛风寒、辟秽浊的功效，临床用于治疗伤寒等
大风子		祛风燥湿、攻毒杀虫的功效，临床用于治疗麻风等
麻黄根		止汗的功效，临床用于治疗自汗、盗汗
苍耳		祛风散热、解毒杀虫的功效，临床用于治疗头风、湿痹拘挛、热毒疮疡等
海金沙		清利湿热、通淋止痛的功效，临床用于治疗热淋、砂淋、石淋、血淋、膏淋、尿道涩痛
虻虫		逐瘀、破积通经的功效
象皮		止血、敛疮的功效，临床用于治疗外伤出血、溃疡
白前		降气、消痰、止咳的功效，临床用于治疗肺气壅实、咳嗽痰多、胸满喘急
虎杖		祛风利湿、散瘀定痛、止咳化痰的功效，临床用于治疗关节痹痛、湿热黄疸、经闭、癥瘕、水火烫伤、跌扑损伤、痈肿疮毒、咳嗽痰多
蓖麻		为大戟科蓖麻属植物，其干燥成熟种子为中药蓖麻子。
紫花地丁		清热解毒、凉血消肿的功效，临床用于治疗疔疮肿毒、痈疽发背、丹毒、毒蛇咬伤
马齿苋		清热解毒、凉血止血的功效，临床用于治疗热毒血痢、痈肿疔疮、湿疹、丹毒、蛇虫咬伤、便血、痔血、崩漏下血
广藿香		芳香化浊、开胃止呕、发表解暑的功效，临床用于治疗湿浊中阻、脘痞呕吐、暑湿倦怠、胸闷不舒、寒湿闭暑、腹痛吐泻
蛤蚧		补肺益肾、纳气定喘、助阳益精的功效，用于虚喘气促、劳嗽咳血、阳痿遗精
谷芽		消食和中、健脾开胃的功效，临床用于治疗食积不消、腹胀口臭、脾胃虚弱、不饥食少
马钱子		通络止痛、散结消肿的功效，临床用于治疗风湿顽痹、麻木瘫痪、跌扑损伤、痈疽肿痛、小儿麻痹后遗症、类风湿性关节痛
金钱草		清利湿热、通淋、消肿的功效，临床用于治疗热淋、沙淋、尿涩作痛、黄疸尿赤、痈肿疔疮、毒蛇咬伤、肝胆结石、尿路结石
胡芦巴		温肾、祛寒、止痛的功效，临床用于治疗肾脏虚冷、小腹冷痛、小肠疝气、寒湿脚气
浙贝母		清热散结、化痰止咳的功效，用于风热犯肺、痰火咳嗽、肺痈、乳痈、瘰疬、疮毒
锁阳		补肾阳、益精血、润肠通便的功效，临床用于治疗腰膝痿软、阳痿滑精、肠燥便秘
桑椹		补血滋阴、生津润燥的功效，临床用于治疗眩晕耳鸣、心悸失眠、须发早白、津伤口渴、内热消渴、血虚便秘
鬼箭羽		破血、通经、杀虫的功效，临床用于治疗经闭、癥瘕
石榴		涩肠止泻的功效
密蒙花		清热养肝、明目退翳的功效，临床用于治疗目赤肿痛、多泪羞明、眼生翳膜、肝虚目暗、视物昏花
太子参		益气健脾、生津润肺的功效，临床用于治疗脾虚体倦、食欲不振、病后虚弱、气阴不足、自汗口渴、肺燥干咳
辛夷		散风寒、通鼻窍的功效，临床用于治疗风寒头痛、鼻塞、鼻渊、鼻流浊涕
青礞石		坠痰下气、平肝镇惊的功效，临床用于治疗顽痰胶结、咳逆喘急、癫痫发狂、烦躁胸闷、惊风抽搐，多入丸散服
莲须		固肾涩精的功效，临床用于治疗遗精滑精、带下、尿频
大青叶		清热解毒、凉血消斑的功效，临床用于治疗温邪入营、高热神昏、发斑发疹、黄疸、热痢、痄腮、喉痹、丹毒、痈肿
皂矾		燥湿化痰、消积杀虫、止血补血、解毒敛疮的功效
车前草		清热利尿、祛痰、凉血、解毒的功效，临床用于治疗水肿尿少、热淋涩痛、暑湿泻痢、痰热咳嗽、吐血衄血、痈肿疮毒
藕节		止血、消瘀的功效，临床用于治疗吐血、咯血、衄血、尿血、崩漏
败酱		清热解毒的功效
橘核		理气、散结、止痛的功效，临床用于治疗小肠疝气、睾丸肿痛、乳痈肿痛
淡豆豉		解表、除烦、宣发郁热的功效，临床用于治疗感冒、寒热头痛、烦躁胸闷、虚烦不眠
松节		祛风、燥湿、舒筋、通络的功效，临床用于治疗历节风痛等
土鳖虫		破瘀血、续筋骨的功效
莨菪		杀虫止痒、解毒杀疟、镇痛解痉的功效，临床用于治疗疥癣、虫疾
白头翁		清热解毒、凉血止痢的功效，临床用于治疗热毒血痢、阴痒带下、阿米巴痢
仙茅		补肾阳、强筋骨、祛寒湿的功效，用于阳痿精冷、筋骨痿软、腰膝冷痹、阳虚冷泻
小蓟		凉血止血、祛瘀消肿的功效，临床用于治疗吐血、衄血、尿血、便血、崩漏下血、外伤出血、痈肿疮毒
大蒜		行滞气、暖脾胃、消症积、解毒、杀虫的功效
白果		敛肺定喘、止带浊、缩小便的功效，临床用于治疗痰多喘咳、带下白浊、遗尿、尿频
忍冬藤		清热解毒、疏风通络的功效，临床用于治疗温病发热、热毒血痢、痈肿疮疡、风湿热痹、关节红肿热痛
北沙参		养阴清肺、益胃生津的功效，临床用于治疗肺热燥咳、虚痨久咳等
野菊花		清热解毒的功效，用于疔疮痈肿、目赤肿痛、头痛眩晕
马勃		清肺利咽、止血的功效，临床用于治疗风热郁肺咽痛、咳嗽、音哑，外治鼻衄、创伤出血
佛手		舒肝理气、和胃止痛的功效，临床用于治疗肝胃气滞、胸胁胀痛、胃脘痞满、食少呕吐
煅石膏		收湿、生肌、敛疮、止血的功效，临床用于治疗溃疡不敛、湿疹瘙痒、水火烫伤、外伤出血
淡竹		清心火、除烦热、利小便的功效
蜂蜜		补中、润燥、止痛、解毒的功效，临床用于治疗脘腹虚痛、肺燥干咳、肠燥便秘，外治疮疡不敛、水火烫伤
两头尖		祛风湿、消痈肿的功效，临床用于治疗风寒湿痹、四肢拘挛、骨节疼痛，痈肿溃烂
楮实子		补肾清肝、明目、利尿的功效，临床用于治疗腰膝酸软、虚劳骨蒸、头晕目昏、目生翳膜、水肿胀满
龙眼肉		补益心脾、养血安神的功效，临床用于治疗气血不足、心悸怔忡、健忘失眠、血虚萎黄
卷柏		活血通经功效，临床用于经闭痛经、癥瘕痞块、跌打损伤
甜瓜子		散结、消瘀、清肺、润肠的功效，临床用于治疗腹内结聚、肠痈等
丝瓜		清热解毒、化痰凉血的功效，临床用于治疗热病烦渴等
梅花		开郁和中、化痰、解毒的功效，临床用于治疗郁闷心烦、肝胃气痛、梅核气、瘰疬疮毒
白花蛇舌草		清热解毒、利湿散瘀的功效，临床用于治疗肺热喘咳等
水牛角		清热解毒、凉血、定惊的功效，临床用于治疗温病高热、神昏谵语、发斑发疹、吐血衄血、惊风、癫狂
马蔺		清热解毒、祛湿除痹、止血利尿、通淋杀虫的功效
鱼腥草		清热解毒、消痈排肿、利尿通淋的功效，临床用于治疗肺痈吐脓、痰热喘咳、热痢、热淋、痈肿疮毒
银柴胡		清虚热、除疳热的功效，临床用于治疗阴虚发热、骨蒸劳热、小儿疳热
制何首乌		补肝肾、益精血、乌须发、强筋骨的功效，临床用于治疗血虚萎黄、眩晕耳鸣、须发早白、腰膝酸软、肢体麻木、崩漏带下、久疟体虚、高血脂
红参		大补元气、复脉固脱、益气摄血的功效，临床用于治疗体虚欲脱、肢冷脉微、气不摄血、崩漏下血、心力衰竭、心原性休克
荔枝核		行气散结、祛寒止痛的功效，临床用于治疗寒疝腹痛、睾丸肿痛
木耳		补气、凉血止血、润肠通便的功效
乌梢蛇		祛风、通络、止痉的功效，临床用于治疗风湿顽痹、麻木拘挛、中风口眼喎斜
珍珠母		平肝潜阳、定惊明目的功效，临床用于治疗头痛眩晕、烦燥失眠、肝热目赤、肝虚目昏
泽漆		利水消肿、消痰、杀虫、清热解毒的功效，临床用于治疗水气、肿满等
莲子心		清心安神、交通心肾、涩精止血的功效，临床用于治疗热入心包、神昏谵语、心肾不交、失眠遗精、血热吐血
龟甲		滋阴潜阳、益肾强骨、养血补心的功效，临床用于治疗阴虚潮热、骨蒸盗汗、头晕目眩、虚风内动、筋骨痿软、心虚健忘
海风藤		祛风湿、通经络、止痹痛的功效，临床用于治疗风寒湿痹、肢体疼痛、筋脉拘挛、屈伸不利
紫草茸		清热解毒、凉血活血、祛湿杀虫、凉血解毒的功效，临床用于治疗麻疹、斑疹不易透发等
黄药子		凉血降火、消瘿解毒的功效
花蕊石		化瘀止血的功效，临床用于治疗咯血，吐血，外伤出血，跌扑伤痛
透骨草		祛风、除湿舒筋、活血、止痛、解毒化疹的功效，临床用于治疗风湿痹痛等
韭菜		温中、行气、散血、解毒的功效
凌霄花		凉血、化瘀、祛风的功效，临床用于治疗月经不调、经闭癥瘕、产后乳肿、风疹发红、皮肤瘙痒、痤疮
苏合香		开窍、辟秽、止痛功效，临床用于治疗中风痰厥、猝然昏倒、胸腹冷痛、惊痫
芒硝		泻热通便、润燥软坚、清火消肿的功效，临床用于治疗实热便秘、大便燥结、积滞腹痛、肠痈肿痛，外治乳痈、痔疮肿痛
鸡冠花		收敛止血、止带、止痢的功效，临床用于治疗吐血、崩漏、便血、痔血、赤白带下、久痢不止
制川乌		祛风除湿、温经止痛、麻醉止痛的功效，临床用于治疗风寒湿痹、关节疼痛，心腹冷痛、寒疝作痛、麻醉止痛
蜘蛛		为圆蛛科动物大腹圆蛛的全体，有毒。
荞麦		开胃宽肠、下气消积、解毒疗疮的功效，临床用于治疗绞肠痧、肠胃积滞等
茶叶		清利头目、除烦止渴、利尿、清热解毒、下气消食、化痰的功效，临床用于治疗心烦口渴等
猪胆汁		益肺、补脾、润燥的功效，临床用于治疗消渴、便秘、黄疸等
藤黄		消肿、化毒、止血、杀虫的功效，临床用于治疗痈疽肿毒等
桂皮		暖脾胃、散风寒、通血脉的功效，临床用于治疗腹冷胸满、呕吐噎膈、风湿痹痛等
刺猬皮		降气定痛、凉血止血的功效，临床用于治疗反胃吐食、腹痛疝气、肠风痔漏、遗精等
核桃仁		补肾、温肺、润肠的功效，临床用于治疗腰膝酸软、阳痿遗精、虚寒喘嗽、大便秘结
蚕砂		祛风除湿、活血定痛的功效，临床用于治疗风湿痹痛、风疹瘙痒、头风头痛等
马鞭草		活血散瘀、截疟、解毒、利水消肿的功效，临床用于治疗癥瘕积聚、经闭痛经、疟疾、喉痹、水肿、热淋
西瓜		清热解暑、除烦止渴、利小便的功效，临床用于治疗暑热烦渴等
山慈菇		清热解毒、化痰散结功效，用于痈肿疔毒、瘰疬痰核、淋巴结结核、蛇虫咬伤
八角茴香		温阳散寒、理气止痛的功效，临床用于治疗寒疝腹痛、肾虚腰痛、胃寒呕吐、脘腹冷痛
仙鹤草		收敛止血、截疟、止痢、解毒的功效，临床用于治疗咯血、吐血、崩漏下血、疟疾、血痢、脱力劳伤、痈肿疮毒、阴痒带下
韭菜子		温补肝肾、壮阳固精的功效，临床用于治疗阳萎遗精、腰膝酸痛、遗尿尿频、白浊带下
柿蒂		降逆下气的功效，临床用于治疗呃逆
墨旱莲		滋补肝肾、凉血止血的功效，临床用于治疗牙齿松动、须发早白、眩晕耳鸣、腰膝酸软、阴虚血热、吐血、衄血、尿血、血痢、崩漏下血、外伤出血
片姜黄		破血行气、通经止痛的作用；用于血滞经闭、行经腹痛、胸胁刺痛、风湿痹痛、肩臂疼痛、跌扑损伤
西洋参		补气养阴、清热生津的功效，临床用于治疗气虚阴亏、内热、咳喘、虚热烦倦、口燥咽干
玳瑁		清热、解毒、镇惊的功效
急性子		破血软坚、消积的功效，临床用于治疗癥瘕痞块、经闭、噎膈
红粉		拔毒、除脓、去腐、生肌的功效
闹羊花		驱风除湿、散瘀定痛的功效，临床用于治疗风湿痹痛、跌打损伤、皮肤顽癣
火麻仁		润肠通便的功效，临床用于治疗血虚津亏、肠燥便秘
黑芝麻		补肝肾、益精血、润肠燥的功效，临床用于治疗头晕眼花、耳鸣耳聋、须发早白、病后脱发、肠燥便秘
水红花子		散血消癥、消积止痛的功效，临床用于治疗癥瘕痞块、瘿瘤肿痛、食积不消、胃脘胀痛
大蓟		凉血止血、祛瘀消肿的功效，临床用于治疗衄血、吐血、尿血、便血、崩漏下血、外伤出血、痈肿疮毒
合欢皮		解郁安神、活血消肿的功效，临床用于治疗心神不安、忧郁失眠、肺痈疮肿、跌扑伤痛
徐长卿		祛风化湿、止痒止痛的功效，临床用于治疗风湿痹痛、胃痛胀满、牙痛、腰痛、跌扑损伤、荨麻疹、湿疹
化橘红		散寒、燥湿、利气、消痰的功效，临床用于治疗风寒咳嗽、喉痒痰多、食积伤酒、呕恶痞闷
路路通		祛风活络、利水通经的功效，临床用于治疗关节痹痛、麻木拘挛、水肿胀满、乳少经闭
重楼		清热解毒、消肿止痛、凉肝定惊的功效，临床用于治疗疔疮痈肿、咽喉肿痛、毒蛇咬伤、跌扑伤痛、惊风抽搐
沙苑子		温补肝肾、固精、缩尿、明目的功效，临床用于治疗肾虚腰痛、遗精早泄、白浊带下、小便余沥、眩晕目昏
天仙藤		行气活血、利水消肿的功效，临床用于治疗脘腹刺痛、关节痹痛、妊娠水肿
制草乌		祛风除湿、温经止痛的功效，临床用于治疗风寒湿痹、关节疼痛、心腹冷痛、寒疝作痛、麻醉止痛
香橼		舒肝理气、宽中、化痰的功效，临床用于治疗肝胃气滞、胸胁胀痛、脘腹痞满、呕吐噫气、痰多咳嗽
滑石粉		利尿通淋、清热解毒、祛湿敛疮的功效，临床用于治疗热淋、石淋、尿热涩痛、暑热烦渴、湿热水泻，外治湿疹、湿疮、痱子
浮小麦		止汗、退热除烦的功效
南沙参		养阴清肺、化痰、益气的功效，临床用于治疗肺热燥咳、阴虚劳嗽、干咳痰粘、气阴不足、烦热口干
天仙子		解痉止痛、安神定喘的功效，临床用于治疗胃痉挛疼痛、喘咳、癫狂
芥子		温肺豁痰利气、散结通络止痛的功效，临床用于治疗寒痰喘咳、胸胁胀痛、痰滞经络、关节麻木、疼痛、痰湿流注、阻疽肿毒
瓦楞子		消痰化瘀、软坚散结、制酸止痛的功效，临床用于治疗顽痰积结、黏稠难咯、瘿瘤、瘰疬、癥瘕痞块、胃痛泛酸
灵芝		药材为多孔菌科真菌灵芝、紫芝的干燥子实体，具补气安神、止咳平喘的功效，临床用于治疗眩晕不眠、心悸气短、虚劳咳喘。
葡萄		补气血、强筋骨、利小便的功效，临床用于治疗气血虚弱、肺虚咳嗽、心悸盗汗等
耳草		清热解毒功效
山柰		行气温中、消食、止痛的功效，用于胸膈胀满、脘腹冷痛、饮食不消
黄皮		行气止痛、消肿利水、除积止痛、理气化痰的功效，临床用于治疗黄疸、疟疾等
土贝母		散结、消肿、解毒的功效，临床用于治疗乳痈、瘰疬、乳腺炎、颈淋巴结结核、慢性淋巴结炎、肥厚性鼻炎
血余炭		止血、化瘀的功效，临床用于治疗吐血、衄血、尿血、崩漏下血、外伤出血
羊蹄		凉血止血、清热通便、利水、杀虫的功效，临床用于治疗大便燥结、淋浊、黄疸
佩兰		芳香化湿、醒脾开胃、发表解暑的功效，临床用于治疗湿浊中阻、脘痞呕恶、口中甜腻、口臭、多涎、暑湿表证、头胀胸闷
岗梅		清热、生津、活血、解毒的功效，临床用于治疗感冒等
菝葜		祛风利湿、解毒散瘀功效，用于筋骨酸痛、小便淋漓、带下量多、疔疮痈肿
榧子		杀虫消积、润燥通便的功效，临床用于治疗钩虫、蛔虫、绦虫、虫积腹痛、小儿疳积、大便秘结
鹅不食草		通鼻窍、止咳的功效，临床用于治疗风寒头痛、咳嗽痰多、鼻塞不通、鼻渊流涕
紫苏梗		理气宽中、止痛、安胎的功效，临床用于治疗胸膈痞闷、胃脘疼痛、嗳气呕吐、胎动不安
红豆蔻		燥湿散寒、醒脾消食的功效，临床用于治疗脘腹冷痛、食积胀满、呕吐泄泻、饮酒过多
半枝莲		清热解毒、化瘀利尿的功效，临床用于治疗疔疮肿毒、咽喉肿痛、毒蛇咬伤、跌扑伤痛、水肿、黄疸
千年健		祛风湿、壮筋骨的功效，用于风寒湿痹、腰膝冷痛、下肢拘挛麻木
饴糖		补气、补虚生津、润燥的功效，临床用于治疗里急腹痛、肺燥咳嗽等
刺五加		益气健脾、补肾安神的功效，临床用于治疗脾肾阳虚、体虚乏力、食欲不振、腰膝酸痛、失眠多梦
丝瓜络		通络、活血、祛风功效，临床用于治疗痹痛拘挛、胸胁胀痛、乳汁不通
马蔺子		清热利湿、解毒消肿、凉血止血、祛湿通痹、健脾和胃的功效
紫檀		消肿、止血、定痛的功效，临床用于治疗肿毒、金疮出血
蛤壳		清热化痰、软坚散结、制酸止痛的功效，临床用于治疗痰火咳嗽、胸胁疼痛、痰中带血、瘰疬瘿瘤、胃痛吞酸，外治湿疹、烫伤
椿皮		清热燥湿、收涩止带、止泻、止血的功效；用于赤白带下、湿热泻痢、久泻久痢、便血、崩漏
瓜蒌皮		清化热痰、利气宽胸的功效，临床用于治疗痰热咳嗽、胸闷胁痛
黄瓜		清热解毒、利水消肿的功效，临床用于治疗咽喉肿痛等
橄榄核		行气止痛的功效，临床用于治疗诸鱼骨鲠、胃痛、疝气等
穿心莲		清热解毒、凉血、消肿的功效，临床用于治疗感冒发热、咽喉肿痛、口舌生疮、顿咳劳嗽、泄泻痢疾、热淋涩痛、痈肿疮疡、毒蛇咬伤
枫香脂		活血止痛、解毒、生肌、凉血的功效，临床用于治疗跌扑损伤、痈疽肿痛、吐血、衄血、外伤出血
瓜蒌子		润肺化痰、滑肠通便的功效，临床用于治疗燥咳痰黏、肠燥便秘
冬瓜皮		利水消肿的功效，临床用于治疗水肿胀满、小便不利、暑热口渴、小便短赤
牡荆		解肌发汗、祛风、化痰的功效，临床用于治疗感冒等
伸筋草		祛风除湿、舒筋活络的功效，临床用于治疗关节酸痛、屈伸不利
千金子		逐水消肿、破血消症的功效，临床用于治疗水肿、痰饮、积滞胀满、二便不通、血瘀经闭，外治顽癣、疣等
钟乳石		温肺、助阳、平喘、制酸、通乳的功效，临床用于治疗寒痰喘咳、阳虚冷喘、腰膝冷痛、胃痛泛酸、乳汁不通
莲房		化瘀止血的功效，临床用于治疗崩漏、尿血、痔疮出血、产后瘀阻、恶露不尽
龙眼		补血功效
青风藤		祛风湿、通经络、利小便的功效，临床用于治疗风湿痹痛、关节肿胀、麻痹瘙痒
首乌藤		养血安神、祛风通络的功效，临床用于治疗失眠多梦、血虚身痛、风湿痹痛，外治皮肤瘙痒
石楠		祛风、活络、益肾的功效，临床用于治疗肾阳虚、风痹等
千里光		清热解毒、清肝明目、祛风燥湿、杀虫的功效，临床用于治疗各种急性炎性疾病、风火赤眼
关木通		清心火、利小便、通经下乳的功效，临床用于治疗口舌生疮、湿热痹证等，但含有马兜铃酸可引发肾病
玫瑰花		行气解郁、和血、止痛的功效，临床用于治疗肝胃气痛、食少呕恶、月经不调、跌扑伤痛
苎麻根		清热、止血、解毒、散瘀的功效，临床用于治疗热病大渴、血淋、癃闭等
香加皮		祛风湿、强筋骨的功效，临床用于治疗风寒湿痹、腰膝酸软、心悸气短、下肢浮肿
莴苣		活血祛瘀、泻热利水、杀虫蛇毒的功效，临床用于治疗小便不利、尿血等
苦楝皮		驱虫、疗癣的功效，临床用于治疗蛔蛲虫病、虫积腹痛，外治疥癣瘙痒
蕲蛇		祛风、通络、止痉的功效，临床用于治疗风湿顽痹、麻木拘挛、中风口眼?斜、半身不遂、抽搐痉挛、破伤风、麻风疥癣
橄榄		清肺、利咽、生津、解毒的功效，临床用于治疗咽喉肿痛、咳嗽、烦渴、鱼蟹中毒
升药		搜脓拔毒、祛腐生肌的功效
天葵		清热解毒、利水的功效，临床用于治疗瘰疬、疝气等
冬虫夏草		补肺益肾、止血、化痰的功效，临床用于治疗久咳虚喘、劳嗽咯血、阳痿遗精、腰膝酸痛
辣椒		温中散寒、开胃消食、活血化瘀、益气消肿的功效，临床用于治疗寒滞腹痛、冻疮、疥癣
凤凰衣		养阴、清肺的功效，临床用于治疗久咳、咽痛失音、瘰疬结核等
老鹳草		祛风湿、通经络、止泻痢的功效，临床用于治疗风湿痹痛、麻木拘挛、筋骨酸痛、泄泻痢疾
蝼蛄		利水、通便的功效
桉油		为祛风止痛的功效，临床用于治疗皮肤瘙痒、神经痛
蜥蜴		消瘿散瘰的功效
半边莲		利尿消肿、清热解毒的功效，临床用于治疗大腹水肿、面足浮肿、痈肿疔疮、蛇虫咬伤、晚期血吸虫病腹水
西河柳		散风、解表、透疹的功效，临床用于治疗麻疹不透、风湿痹痛
女贞		行气活血、强筋壮骨、祛风明目、解毒消肿的功效，临床用于治疗胁痛、闭经、肾虚腰痛等
山芝麻		解表清热、消肿解毒的功效，临床用于治疗感冒发热、头痛
金果榄		清热解毒、利咽、止痛的功效，临床用于治疗咽喉肿痛、痈疽疔毒、泄泻、痢疾、脘腹热痛
瓦松		止血、解毒、敛疮的功效，用于血痢、便血、疮口久不愈合
龙葵		清热解毒、活血消肿的功效，临床用于治疗疔疮、痈肿、丹毒
川木通		清热利尿、通经下乳的功效，临床用于治疗水肿、淋病、小便不通、关节痹痛、经闭乳少
豹骨		追风定痛、强筋健骨的功效，临床用于治疗筋骨疼痛、风寒湿痹、四肢拘挛、麻木、腰膝酸楚
拳参		清热解毒、消肿、止血的功效，临床用于治疗赤痢、热泻、肺热咳嗽、痈肿、瘰疬、口舌生疮、吐血、衄血、痔疮出血、毒蛇咬伤
九节菖蒲		开窍豁痰、祛风宣湿、健胃解毒的功效，临床用于治疗热病神昏谵语、癫痫痰厥
金沸草		降气、消痰、行水的功效，临床用于治疗风寒咳嗽、痰饮蓄结、痰壅气逆、胸膈痞满、喘咳痰多，外治疔疮肿毒
凤仙花		祛风湿、活血、通经的功效
凤尾草		清热利湿、凉血止血、消肿解毒的功效，临床用于治疗黄疸型肝炎、肠炎等
豌豆		和中下气、利小便、解疮毒的功效，临床用于治疗霍乱、脚气、痈肿
地枫皮		祛风除湿、行气止痛的功效，临床用于治疗风湿痹痛、腰肌劳损
李子		清热、生津的功效，临床用于治疗虚劳骨蒸、消渴、腹水等
九香虫		理气止痛、温中助阳的功效，用于胃寒胀痛、肝胃气痛、肾虚阳痿、腰膝酸痛
罂粟		涩肠固脱、行气止痛的功效，临床用于治疗反胃、腹痛等
西红花		活血化瘀、凉血解毒、解郁安神的功效，临床用于经闭癥瘕、产后瘀阻、温毒发斑、忧郁痞闷、惊悸发狂
红大戟		泻水逐饮、攻毒消肿散结的功效，临床用于治疗胸腹积水、二便不利、痈肿疮毒、瘰疬痰核
络石藤		祛风通络、凉血消肿的功效，临床用于治疗风湿热痹、筋脉拘挛、腰膝酸痛、喉痹、痈肿、跌扑损伤
木蝴蝶		清肺利咽、疏肝和胃的功效，临床用于肺热咳嗽、喉痹、音哑、肝胃气痛
合欢花		解郁安神的功效，临床用于治疗心神不安、忧郁失眠
海狗肾		暖肾壮阳、益精补髓的功效，临床用于治疗虚损劳伤、阳痿精衰、腰膝痿弱等
辣蓼		祛风湿、活血祛瘀的功效
稻芽		和中消食、健脾开胃的功效，用于食积不消、腹胀口臭、脾胃虚弱、不饥食少
地锦草		清热解毒、活血止血的功效，临床用于治疗痢疾、泄泻、咯血、尿血、便血、崩漏、疮疖痈肿
芫荽		发汗解表、宣透麻疹、消食下气的功效，临床用于治疗麻疹透发不利、食物积滞
雷公藤		祛风湿、消炎解毒的功效，临床用于治疗风湿性关节炎
五加		活血祛瘀、祛风湿功效
莳萝		温脾开胃功效
浮海石		化痰的功效
矮地茶		化痰止咳、利湿、活血的功效，临床用于治疗新久咳嗽、痰中带血、湿热黄疸、跌打损伤
黑大豆		活血、利水、祛风、解毒、明目退翳的功效，临床用于治疗水肿胀满等
花生		润肺、和胃的功效，临床用于治疗燥咳等
冬葵		祛湿利水、润下功效
穿山龙		祛风湿、止痛、舒筋活血、止咳平喘祛痰的功效，临床用于治疗风湿性关节炎、腰腿疼痛、麻木，大骨节病、跌扑损伤、闪腰岔气、慢性支气管炎、咳嗽气喘
郁李		降气、止咳平喘的功效
甜瓜		生津止渴、清暑热、解烦渴、利小便的功效，临床用于治疗消渴等
蜂蜡		收涩、敛疮、生肌、止痛的功效，临床用于治疗溃汤不敛、臁疮糜烂、创伤、烧烫伤
鹿衔草		祛风湿、强筋骨、止血的功效，临床用于治疗风湿痹痛、腰膝无力、月经过多、久咳劳嗽
土木香		健脾和胃、调气解郁、止痛安胎的功效，临床用于治疗胸胁、脘腹胀痛、呕吐泻痢、胸胁挫伤、岔气作痛、胎动不安
罗勒		疏风行气、化湿消食、活血、解毒的功效，临床用于治疗外感头痛等
十大功劳		清热泻火、凉血解毒的功效，临床用于治疗流感、热痢、腹泻等
余甘子		清热凉血、消食健胃、生津止咳功效，临床用于治疗血热血瘀、消化不良、腹胀、咳嗽、喉痛、口干，多入丸散服
垂盆草		清利湿热、解毒的功效，临床用于治疗湿热黄疸、小便不利、痈肿疮疡、急慢性肝炎
地胆草		清热解毒、利尿消肿的功效，临床用于治疗感冒、急性扁桃体炎、咽喉炎、眼结膜炎、流行性乙型脑炎等病症
槲寄生		祛风湿、补肝肾、强筋骨、安胎的功效，用于风湿痹痛、腰膝酸软、胎动不安
广金钱草		清热除湿、利尿通淋的功效，临床用于治疗热淋、砂淋、石淋、小便涩痛、水肿尿少、黄疸尿赤、尿路结石
洋金花		平喘止咳、镇痛、解痉的功效，临床用于治疗哮喘咳嗽、脘腹冷痛、风湿痹痛、小儿慢惊、外科麻醉
玉米须		利尿、泄热、平肝、利胆的功效，临床用于治疗肾炎水肿、脚气、黄疸肝炎等
寻骨风		祛风通络的功效，临床用于治疗风湿关节痛等
鸦胆子		清热解毒、截疟、止痢、腐蚀赘疣的功效，临床用于治疗痢疾、疟疾，外治赘疣、鸡眼
望月砂		明目、杀虫的功效，临床用于治疗目暗生翳、疳疾、痔瘘
满山红		止咳、祛痰的功效，临床用于治疗慢性支气管炎
三叉苦		清热解毒的功效
千金子霜		逐水消肿、破血消症的功效，临床用于治疗水肿、痰饮、积滞胀满、二便不通、血瘀经闭，外治顽癣、疣等
棕榈炭		收涩止血的功效，临床用于治疗吐血、衄血、尿血、便血、崩漏下血
丁公藤		祛风除湿、消肿止痛的功效，临床用于治疗风湿痹痛、半身不遂、跌打肿痛
朱砂七		止血、清热解毒功效，临床用于治疗痈肿、外伤出血等
预知子		舒肝理气、活血止痛、利尿、杀虫的功效，临床用于治疗脘胁胀痛、经闭痛经、小便不利、蛇虫咬伤
灶心土		温中燥湿、和胃止呕、温脾涩肠、止血的功效，临床用于治疗呕吐反胃、腹痛泄泻、出血等
积雪草		清热利湿、解毒消肿的功效，临床用于治疗湿热黄疸、中暑腹泻、砂淋血淋、痈肿疮毒、跌扑损伤
灯心草		清心火、利小便的功效，临床用于治疗心烦失眠、尿少涩痛、口舌生疮
芜菁		利湿解毒、降气宽中、平喘止咳、养肝明目、破积通淋的功效，临床用于治疗食积不化、黄疸、消渴等
六月雪		祛风利湿、清热解毒的功效，临床用于治疗风湿腰腿痛、痢疾、水肿等
土荆皮		杀虫止痒的功效，临床用于治疗疥癣
火炭母		清热利湿、凉血解毒的功效，临床用于治疗泄泻、痢疾、黄疸、风热咽痛等
人参芦		涌吐、升阳的功效，临床用于治疗虚人痰壅阻膈、气陷泄泻等
平贝母		清热润肺、化痰止咳的功效，临床用于治疗肺热燥咳、干咳少痰、阴虚劳嗽、咳痰带血
紫珠		活血止血、除热解毒的功效，临床用于治疗吐血、咯血等
龟甲胶		为龟科动物的龟甲经煎煮、浓缩制成的固体胶，有滋阴、养血、止血功效，临床用于治疗阴虚潮热、骨蒸盗汗、腰膝酸软，血虚萎黄、崩漏带下。
石楠藤		祛风湿的功效
臭梧桐		祛风除湿、消积导滞、疗疳除疾、截疟、消肿散瘀、解毒疗疮的功效，临床用于治疗风湿痹痛等
胖大海		清热润肺、利咽解毒、润肠通便的功效，临床用于治疗肺热声哑、干咳无痰、咽喉干痛、热结便闭、头痛目赤
鼠妇		破血、利水解毒、止痛的功效
穿破石		祛风利湿、活血通经的功效，临床用于治疗风湿关节疼痛、黄疸等
毛冬青		清热解毒、活血通络、利水渗湿的功效，临床用于治疗肺热咳喘等
石见穿		活血化瘀、清热利湿、散结消肿的功效，临床用于治疗月经不调等
麦饭石		解毒排脓的功效
绿萼梅		疏肝解郁作用，临床用于治疗胸胁苦满、肝气郁结、月经不调等
紫贝齿		清热、平肝安神、明目的功效
海参		补肾益精、养血润燥的功效
明党参		润肺化痰、养阴和胃、平肝、解毒的功效，临床用于治疗肺热咳嗽、呕吐反胃、食少口干、目赤眩晕、疔毒疮疡
五指毛桃		健脾补肺、行气利湿、化痰的功效，临床用于治疗肺痨咳嗽、盗汗等
杜仲叶		补肝肾、强筋骨的功效，用于肝肾不足、头晕目眩、腰膝酸痛、筋骨痿软
金礞石		坠痰下气、平肝镇惊的功效，临床用于治疗顽痰胶结、咳逆喘急、癫痫发狂、烦躁胸闷、惊风抽搐
蝮蛇		祛风、攻毒的功效
广枣		行气活血、养心，安神的功效，临床用于治疗气滞血瘀、胸痹作痛，心悸气短，心神不安
海龙		补肾壮阳、散结消肿的功效，用于阳痿遗精、癥瘕积聚、瘰疬痰核、跌扑损伤，外治痈肿疔疮
黄狗肾		补益的功效，临床用于治疗虚证
万年青		强心利尿、清热解毒、止血的功效
焦槟榔		消食导滞的功效，临床用于治疗食积不消、泻痢后重
北豆根		清热解毒、祛风止痛的功效，临床用于治疗咽喉肿痛、肠炎痢疾、风湿痹痛
水杨梅		清热解毒、止血的功效，临床用于治疗高热泻痢、外伤出血等
葫芦茶		清热解毒、利湿消滞、杀虫的功效，临床用于治疗感冒等
苦瓜		清暑涤热、明目解毒、清热止痢、降气止痛的功效，临床用于治疗热病烦渴等
刀豆		温中、下气、止呃的功效，临床用于虚寒呃逆、呕吐
救必应		清热解毒、清热燥湿、消肿止痛的功效，临床用于治疗感冒发热等
一枝黄花		疏风清热、消肿解毒的功效，临床用于治疗感冒头痛、咽喉肿痛、黄疸
川木香		行气止痛的功效，临床用于脘腹胀痛、肠鸣腹泻、里急后重、两胁不舒、肝胆疼痛
苎麻		清热、止血的功效
厚朴花		理气，化湿的功效，临床用于治疗胸脘痞闷胀满、纳谷不香
青葙		燥湿清热、杀虫、止血、明目去翳的功效，临床用于治疗风瘙身痒、疮疥等
绞股蓝		消炎解毒、止咳祛痰的功效，临床用于治疗慢性气管炎
大血藤		清热解毒、活血，祛风的功效，临床用于肠痈腹痛、经闭痛经、风湿痹痛、跌扑肿痛
荔枝草		凉血止血、利水消肿、解毒杀虫的功效，临床用于治疗咳血等
臭牡丹		消肿解毒、祛风除湿、健脾除疳、养血平肝、消痔提肛的功效，临床用于治疗痈疽等
南板蓝根		清热解毒、凉血的功效，临床用于治疗温病发斑、丹毒、流感、流脑
番泻叶		泻热行滞，通便，利水的功效，临床用于治疗热结积滞，便秘腹痛，水肿胀满
雪上一枝蒿		消炎止痛、祛风除湿的功效，临床用于治疗跌打损伤等
黄栌		清热解毒、清利湿热的功效，临床用于治疗黄疸、漆疮、皮肤瘙痒症
白英		清热燥湿、祛风止痛、活血祛瘀的功效，临床用于治疗风火牙痛、头痛等
蚕豆		健脾、利湿的功效，临床用于治疗膈食、水肿、小便不利
毛诃子		清热解毒、收敛养血、调和诸药的功效，临床用于治疗各种热证、泻痢、黄水病、肝胆病、病后虚弱
了哥王		清热解毒、消肿散结、止痛的功效，临床用于治疗瘰疬、痈肿、风湿痛等
云芝		免疫调节作用，用于治疗慢性肝炎、活动性肝炎
银耳		滋补生津、润肺养胃的功效
功劳木		清热燥湿、泻火解毒的功效，用于湿热泻痢、黄疸、目赤肿痛、胃火牙痛、疮疖、痈肿、痢疾、黄疸型肝炎
鸡骨草		清热解毒、疏肝止痛的功效，临床用于治疗黄疸、胁肋不舒、胃脘胀痛、急慢性肝炎、乳腺炎
守宫		祛风、定惊散结、解毒的功效
枇杷		润肺、止渴、下气的功效，临床用于治疗肺痿咳嗽吐血、衄血等
铁苋菜		清热、利水、杀虫、凉血止血的功效，临床用于治疗痢疾等
木槿		清热止痢、解毒疗疮、清肺止咳、凉肝熄风、燥湿止痒的功效，临床用于治疗疔疮疖肿等
天名精		祛痰、清热、破血、止血、解毒、杀虫的功效，临床用于治疗乳蛾、喉痹等
猫爪草		散结、消肿的功效，临床用于治疗瘰疬未溃，淋巴结结核
鲜地黄		清热生津、凉血、止血的功效，临床用于治疗热病伤阻、舌绛烦渴、发斑发疹、吐血、衄血、咽喉肿痛
土荆芥		祛风、杀虫、通经、止痛的功效，临床用于治疗风湿痹痛、虫证等
罗汉果		清热润肺、滑肠通便的功效，临床用于治疗肺火燥咳、咽痛失音、肠燥便秘
鸭跖草		清热解毒、利水消肿的功效；用于治疗风热感冒、高热不退、咽喉肿痛、水肿尿少、热淋涩痛、痈肿疔毒
七叶莲		祛风除湿、活血止痛的功效，临床用于治疗风湿痹痛、胃痛等
九里香		行气止痛、活血散瘀的功效，临床用于治疗胃痛、风湿痹痛，外治牙痛、跌扑肿痛、虫蛇咬伤
四季青		清热解毒、生肌敛疮、活血止血的功效，临床用于治疗肺热咳嗽等
蘑菇		安神、开胃、止泻、止吐的功效，临床用于治疗腹泻等
枸橘		疏肝理气、行气止痛、祛风止痒、解酒毒、消肿止呕的功效，临床用于治疗胸腹胀满、胃痛等
八月札		舒肝理气、活血止痛、除烦利尿的功效，临床用于治疗肝胃气痛、胃热食呆、烦渴、赤白痢疾、腰痛、胁痛、疝气、痛经、子宫下坠
列当		补肾壮阳、强筋、止泻的功效，临床用于治疗肾虚腰膝冷痛等
一点红		清热解毒的功效
天葵子		清热解毒、消肿散结的功效，临床用于治疗痈肿疔疮、乳痈、瘰疬、毒蛇咬伤
咖啡		理气作用
苦木		清热、祛湿、解毒的功效，临床用于治疗风热感冒、咽喉肿痛、腹泻下痢、湿疹、疮疖、毒蛇咬伤
月季花		活血调经的功效，临床用于治疗月经不调、痛经
蓼大青叶		清热解毒、凉血消斑的功效，临床用于治疗温病发热、发斑发疹、肺热喘咳、喉痹、痄腮、丹毒、痈肿
广防己		祛风止痛、清热利水的功效，临床用于治疗湿热身痛等
松花粉		燥湿、收敛止血的功效，临床用于治疗湿疹、黄水疮、皮肤糜烂、脓水淋沥、外伤出血、尿布性皮炎
罗布麻叶		平肝安神、清热利水的功效，临床用于治疗肝阳眩晕、心悸失眠、浮肿尿少、高血压、神经衰弱、肾炎水肿
肿节风		清热凉血、活血消斑、祛风通络的功效，用于血热紫斑、紫癜、风湿痹痛、跌打损伤
胡颓子		收敛止遗、止咳平喘、健脾消积、清热利咽的功效，临床用于治疗泻痢等
鹧鸪菜		杀虫的功效，临床用于治疗蛔虫病、虫疳
鸡矢藤		祛风活血、止痛解毒、消食导滞的功效，临床用于治疗风湿疼痛、腹泻痢疾、脘腹痛
人参叶		补气、益肺、祛暑、生津的功效，临床用于治疗气虚咳嗽、虚热烦躁、津伤口渴、头目不清、四肢倦乏
连钱草		利湿通淋、清热解毒、散瘀消肿的功效，临床用于治疗热淋、石淋、湿热黄疸、疮痈肿痛、跌扑损伤
砒石		截疟、杀虫的功效，内服具有解毒功效
铁包金		化瘀止血、祛风胜湿、消肿解毒的功效，临床用于治疗肺痨久咳、风湿疼痛等
三分三		麻醉镇痛的功效，临床用于治疗胃痛、骨折、风湿痛
苦地丁		清热毒、消痈肿的功效，临床用于咽喉肿痛、疔疮痛肿、痈疽发背、痄腮丹毒
蜂胶		抗菌消炎、调节免疫、抗氧化、加速组织愈合的作用，用于高脂血症和糖尿病的辅助治疗
水飞蓟		清热解毒、舒肝利胆的功效，临床用于治疗肝胆湿热、胁痛、黄疸
当药		清热、健胃、利湿的功效，临床用于治疗消化不良、胃炎、黄疸、火眼、牙痛、口疮等
沙棘		止咳祛痰、消食化滞、活血散瘀的功效，临床用于治疗咳嗽痰多、消化不良、食积腹痛、瘀血经闭、跌扑瘀肿
银杏叶		敛肺、平喘、活血化瘀、止痛的功效，临床用于治疗肺虚咳喘、冠心病、心绞痛、高脂血症
仙人掌		行气活血、清热解毒、凉血止血、清肺止咳的功效，临床用于治疗心胃气痛、痞块、出血
苘麻		解毒、祛风的功效，临床用于治疗关节酸痛等
红木香		行气调中、活血通络、止痛的功效，临床用于治疗气滞腹胀痛、胃痛等
南五味子		收敛固涩、益气生津、补肾宁心的功效，临床用于治疗久嗽虚喘、梦遗滑精、遗尿尿频、久泻不止、自汗、盗汗、津伤口渴、短气脉虚、内热消渴、心悸失眠
三棵针		清热解毒的功效
板栗		益气健脾、补肾强筋、活血消肿的功效
三叶青		清热解毒、活血祛瘀功效
番石榴		涩肠止泻、解毒止痛的功效，临床用于治疗痢疾、腹泻、湿毒等
木芙蓉叶		凉血、解毒、消肿、止痛的功效，临床用于治疗痈疽等
苘麻子		清热利湿、解毒、退翳的功效，临床用于治疗赤白痢疾、淋病涩痛、痈肿、目翳
云实		清热除湿、杀虫、行气止痛、截疟、止消渴的功效，临床用于治疗痢疾等
野马追		清热解毒、祛痰、定喘、降血压的功效，临床用于治疗慢性气管炎、支气管炎、高血压病
木棉		清热利湿、收敛止血的功效，临床用于治疗慢性胃炎、胃溃疡出血、赤痢、瘰疬
地耳草		清热利湿、解毒消肿、散瘀止痛的功效，临床用于治疗传染性肝炎、泻痢、小儿惊风等
白屈菜		镇痛、止咳、利尿解毒的功效，临床用于治疗胃肠疼痛、黄疸等
金莲花		清热解毒的功效，临床用于治疗上呼吸道感染、扁桃体炎等
金钱白花蛇		祛风、通络、止痉的功效，临床用于治疗风湿顽痹、麻木拘挛、中风口?、半身不遂、抽搐痉挛、破伤风、麻风疥癣、瘰疬恶疮
猕猴桃		清热解毒、利尿通淋、健胃和中的功效，临床用于治疗烦热、消渴等
萹蓄		利尿通淋、杀虫、止痒的功效，临床用于治疗膀胱热淋、小便短赤、淋沥涩痛、皮肤湿疹、阴痒带下
无花果		清热解毒、健胃清肠的功效，临床用于治疗肠炎、痢疾、便秘等
紫花杜鹃		镇咳、祛痰的功效，临床用于治疗慢性气管炎
石花		养血、明目、补肾、利尿、清热、解毒的功效
朱砂根		解毒消肿、活血止痛、祛风除湿的功效，临床用于治疗咽喉肿痛、风湿痹痛、跌打损伤
木芙蓉		清热燥湿、止咳化痰的功效，临床用于治疗痈肿等
溪黄草		清热利湿、凉血散瘀的功效，临床用于治疗急性肝炎等
南瓜		补中益气、消炎止痛、解毒杀虫的功效，临床用于治疗脚气病等
大头陈		驱风解表、清热燥湿的功效，临床用于治疗感冒头痛、腹痛泄泻、皮炎等
雪莲花		温肾壮阳、温经散寒、祛寒化痰、祛风除湿、止血的功效，临床用于治疗阳萎等
过山龙		活血散瘀、解毒消肿、祛风除痹、生肌长骨的功效，临床用于治疗跌打损伤、疮痈肿疖、痹症
海胆		软坚散结、化痰消肿的功效
菠菜		养血止血、敛阴燥湿、疏散风热、利肺润肠的功效，临床用于治疗便血、衄血、消渴等
石吊兰		清肺消痰、凉血止血、祛湿化滞、通络止痛的功效，临床用于治疗肺热咳嗽、吐血等
柠檬		生津止渴、祛暑益气、下气和胃、安胎的功效，临床用于治疗胃痛、流产等
翻白草		清热解毒、止血消肿的功效，临床用于治疗痢疾、疟疾等
三白草		清热解毒、利尿通淋的功效，临床用于治疗小便不利、淋沥涩痛、白带、尿路感染、肾炎水肿，外治疮疡肿毒、湿疹
山楂叶		活血化瘀、理气通脉功效，临床用于治疗气滞血瘀、胸闷憋气、心悸健忘、眩晕耳鸣
黄藤		清热解毒、泻火通便的功效，临床用于治疗热毒内盛、便秘、泻痢、咽喉肿痛、目赤红肿、痈肿疮毒
冬凌草		清热解毒的功效
香茅		疏风解表、祛瘀通脉的功效
吉祥草		清肺止咳、止血、解毒的功效
金荞麦		清热解毒、排脓祛瘀的功效，临床用于治疗肺脓疡、麻疹肺炎、扁桃体周围脓肿
买麻藤		祛风除湿、活血散瘀、止咳化痰的功效，临床用于治疗跌打损伤、风湿骨痛、鹤膝风等
墓头回		祛风止疟、祛瘀止血的功效，临床用于治疗温疟等
八角枫		疏风散寒、行气通络的功效，临床用于治疗风湿疼痛等
华山参		平喘止咳、安神镇惊的功效，临床用于治疗寒痰喘咳、心悸失眠易惊
紫金龙		止痛、降压、止血的功效，临床用于治疗各种疼痛、高血压、跌打损伤等
绵马贯众		清热解毒、驱虫的功效；临床用于治疗虫积腹痛、疮疡
锦灯笼		清热解毒、利咽、化痰、利尿的功效，临床用于治疗咽痛音哑、痰热咳嗽、小便不利，外治疱疮、湿疹
夹竹桃		强心利尿、祛痰定喘、镇痛、散瘀的功效，临床用于治疗喘息咳嗽、癫痫等
除虫菊		燥湿灭虫、除蚊灭虫的功效，临床用于治疗疥癣，灭蚊、蝇、跳蚤、虱、臭虫
木槿皮		清热利湿、杀虫止痒、清热解毒的功效，临床用于治疗肠风下血等
蚱蜢		安神、活血功效
天山雪莲		本品系维吾尔族习用药材。为菊科植物天山雪莲的干燥地上部分。维吾尔医：补肾活血，强筋骨，营养神经，调节异常体液；用于风湿性关节炎、关节疼痛、肺寒咳嗽、肾与小腹冷痛、白带过多等。中医：温肾助阳，祛风胜湿，通经活血；用于风寒湿痹痛、类风湿性关节炎、小腹冷痛、月经不调。
玉兰		清热的功效
萆薢		利水、祛风利湿的功效
芒果		生津止呕、利尿、行气疏滞、生津止渴、解毒疗疮的功效，临床用于治疗口渴、呕吐、伤暑等
朱砂莲		清火消肿、散血止痛、解蛇毒的功效，临床用于治疗红白痢疾、胸痛等
漆姑草		清热解毒、排脓消肿的功效，临床用于治疗漆疮、秃疮、痈肿等
马钱		祛风湿的功效
鼠曲草		化痰、止咳、祛风寒的功效，临床用于治疗咳嗽痰多、气喘等
小叶莲		调经活血的功效，临床用于治疗血瘀经闭、难产、死胎、胎盘不下
西瓜皮		清热解暑、止渴、利小便的功效，临床用于治疗暑热烦渴等
猫眼草		祛痰平喘、利水渗湿的功效，临床用于治疗咳嗽等
亚麻子		润燥、祛风的功效，临床用于治疗肠燥便秘、皮肤干燥瘙痒、毛发枯萎脱落
灯盏细辛		祛风散寒、活血通络止痛的功效，临床用于治疗风寒湿痹痛、中风瘫痪、胸痹心痛、牙痛、感冒
人参果		强心补肾、生津止渴、补脾健胃、调经活血的功效
猪殃殃		清热解毒、散瘀消肿的功效，临床用于治疗淋浊、尿血、跌打损伤等
鹿茸草		凉血止血、清热解毒、祛湿止痛、解毒消肿的功效，临床用于治疗感冒心中烦热、咳嗽、吐血等
百蕊草		清热解毒、补肾涩精、通脉下乳的功效，临床用于治疗急性乳腺炎、肺炎等
蓍草		祛风止痛、活血、解毒的功效，临床用于治疗感冒发热、头痛等
亚麻		平肝、补虚、活血、止痛、顺气、润肠的功效，临床用于治疗慢性肝炎、睾丸炎等
南天竹		清热燥湿、止咳平喘的功效
杠板归		利水消肿、清热、活血、解毒的功效，临床用于治疗水肿、黄疸、泄泻等
藏菖蒲		温胃、消炎止痛的功效；用于补胃阳、消化不良、食物积滞、白喉、炭疽等
爵床		清热解毒、利湿消滞、活血止痛的功效，临床用于治疗感冒发热等
盐肤木		祛风湿、散瘀血、清热解毒的功效，临床用于治疗咳嗽、风湿骨痛、水肿等
甲鱼		补阴、清热凉血作用
虎耳草		祛风、清热、凉血、解毒的功效，临床用于治疗风疹、中耳炎、丹毒等
雪胆		清热、解毒、消肿、止痛的功效，临床用于治疗咽喉肿痛等
红景天		益气活血、通脉平喘的功效，临床用于治疗气虚血瘀、胸痹心痛、中风偏瘫、倦怠气喘
独一味		活血止血、祛风止痛、干黄水的作用，用于治疗跌打损伤、外伤出血、风湿痹痛、黄水疮
冬葵果		清热利尿、消肿的功效，临床用于尿闭、水肿、口渴、尿路感染
哈蟆油		补肾益精、养阴润肺的功效，临床用于治疗阴虚体弱、神疲乏力、心悸失眠、盗汗不止、痨嗽咳血
石上柏		辛温解表、祛风除湿的功效，临床用于治疗咽喉肿痛、目赤肿痛、肺热咳嗽等
大麻药		镇痛、消肿止血的功效，临床用于治疗风湿痛等
黄鳝		活血的功效
喜树		清热、抗肿瘤的功效，临床用于治疗各种癌症、急慢性白血病、银屑病、肝脾肿大
九节茶		抗菌消炎、祛风除湿、活血止痛的功效，临床用于治疗肺炎等
糙苏		清热消肿的功效，临床用于治疗虫咬伤等
石蒜		祛痰、利尿解毒、催吐的功效
景天三七		止血、化瘀的功效，临床用于治疗吐血、衄血、便血等
三叶草		止咳平喘的功效，临床用于治疗咳嗽等
马铃薯		和胃健中、解毒消肿的功效，临床用于治疗胃痛、痈肿、湿疹等
红根草		清热解毒、涩肠止痢的功效，临床用于治疗菌痢
陆英		祛风除湿的功效，临床用于治疗风湿痹痛、脚气、皮肤瘙痒
草乌叶		清热、解毒、止痛的功效，临床用于热病发热、泄泻腹痛、头痛、牙痛
水蜈蚣		疏风解毒、利湿退黄、消肿止痛的功效
柽柳		疏风散寒、解表止咳、升散透疹、祛风除湿、消痞解酒的功效，临床用于治疗麻疹难透、风疹身痒、感冒、咳喘等
千日红		清肝、散结、止咳定喘的功效，临床用于治疗头风、目痛等
石刁柏		清热利湿、活血散结的功效
鹤草芽		杀虫的功效，临床用于治疗绦虫病
臭灵丹		清热解毒、杀虫疗伤截疟的功效，临床用于治疗上呼吸道感染等
杜鹃		止血的功效
断血流		止血的作用，临床用于治疗崩漏、尿血、鼾衄、牙龈出血、创伤出血、子宫肌瘤出血
草血竭		活血散血、和胃止痛、下气消食、消痞散结、利尿消肿的功效，临床用于治疗慢性胃炎、胃及十二指肠溃疡、外伤出血
鲈鱼		补虚功效
草莓		止咳、清热解毒功效
黑种草子		补肾健脑、通经、通乳、利尿作用；用于耳鸣健忘、经闭乳少、热淋、石淋
烟草		行气止痛、解毒杀虫的功效，临床用于治疗食滞饱胀、气结疼痛等
委陵菜		清热解毒、凉血止痢的功效，临床用于治疗赤痢腹痛、久痢不止、痔疮出血、痈肿疮毒
蓼蓝		清热解毒、凉血止血的功效
青叶胆		清肝利胆、清热利湿的功效，临床用于治疗黄疸尿赤、热淋涩痛
飞扬草		清热利湿、解毒消肿的功效，临床用于治疗疟疾等
南瓜子		驱虫、利尿、止咳的功效，临床用于治疗绦虫、蛔虫等
松塔		止咳化痰的功效，临床用于治疗慢性气管炎、咳嗽等
番茄		生津止渴、健脾消食的功效，临床用于治疗口渴、食欲不振
黑蚂蚁		解毒消肿、祛风湿的功效
山银花		清热解毒、凉散风热的功效，临床用于治疗痈肿疔疮、喉痹、丹毒、热毒血痢、风热感冒、温热发病
岩白菜		滋补强壮、止血化痰、清热的功效，临床用于治疗虚弱头晕、劳伤咳嗽等
关黄柏		清热燥湿、泻火除蒸、解毒疗疮的功效，临床用于治疗湿热泻痢、黄疸、带下、热淋、脚气、痿躄、骨蒸劳热、盗汗、遗精、疮疡肿毒、湿疹瘙痒
龙须藤		清热解毒、利尿通淋、祛风止痛的功效，临床用于治疗咽喉肿痛等
八角莲		清热解毒、化痰散结、祛瘀消肿的功效，临床用于治疗痈肿、瘰疬、喉蛾等
牛筋草		清热利湿的功效
罗汉松		散瘀消肿、清热解毒的功效，临床用于治疗跌打损伤、疼痛
缬草		镇静安神、活血祛瘀、温经散寒的功效，临床用于治疗心神不安等
柿树		清湿热、利肝胆、活血化瘀功效
落新妇		辛凉解表、活血祛瘀、止痛、解毒的功效，临床用于治疗风热感冒、头身疼痛等
洋葱		清热解毒的功效
大叶桉		清热解毒、收敛生肌的功效，临床用于治疗感冒、急性肠炎、痢疾等
瓜子金		化痰止咳、活血止血、安神、清热解毒的功效，临床用于治疗咳嗽、失眠等
灵猫香		辟秽、行气、止痛的功效，临床用于治疗心腹卒痛、疝气痛、心绞痛等
枸骨叶		清热养阴、平肝、益肾的功效，临床用于治疗肺劳咳血、骨蒸潮热、头晕目眩、高血压